token	normalised
fecit	fecit
constantin᷒	constantinus
celebrari	celebrari
ꝯcilium	concilium
Expliciunt	Expliciunt
tituli	tituli
libri	libri
pͥmi	primi
Incip̃	Incipit
lib̃	liber
I	I
Oratio	Oratio
allocutoria	allocutoria
sozomeni	sozomeni
ad	ad
theodosiũ	theodosium
ĩꝑator	imperator
Aiunt	Aiunt
antiquis	antiquis
pͥncipib	principibus
diligen	diligen
tie	tie
studium	studium
fuisse	fuisse
ut	ut

eis	eis
amato	amato
res	res
qͥdem	quidem
ornam̃to	ornamentorum
purpuram	purpuram
atq	atque
coronam	coronam
et	et
his	his
similia	similia
pa	prepa
rarent	rarent
Libroꝝ	Librorum
uͦ	uero
h̃ntes	habentes
inten	inten
tionem	tionem
circa	circa
quasdã	quasdam
fabulas	fabulas
occupati	occupati
conscͥp	conscrip
tiones	tiones
agerent	agerent

regalib	regalibus
eoꝝ	eorum
studentes	studentes
reb	rebus
illis	illis
q̃	que
forent	forent
gratissime	gratissime
dñatui	dominatui
Auus	Auus
itaq̃	itaque
lapides	lapides
ciosos	preciosos
difficile	difficile
comꝑtos	compertos
offerebat	offerebat
alt̃	alter
tinctu	tinctu
ram	ram
purpura	purpura
clariorẽ	clariorem
plurimi	plurimi
poemata	poemata
aut	aut
diũsas	diuersas

conscͥptiones	conscriptiones
insinuabant	insinuabant
alius	alius
bona	bona
cingl̃	cingul
aut	aut
optimũ	optimum
armoꝝ	armorum
pandebat	pandebat
usum	usum
maxima	maxima
uͦ	uero
et	et
imꝑialis	imperialis
putabat᷑	putabatur
h᷒	huius
popularis	popularis
Antonini	Antonini
req	req
uire	uire
agapiti	agapiti
uir	uir
agiulphi	agiulphi
req	req
uire	uire

malcelli	malcelli
Uigl̃	Uigilia
sc̃i	sancti
Bertini	Bertini
ut	ut
in	in
uigl̃	uigilia
sc̃i	sancti
iacobi	iacobi
In	In
die	die
s̃	sancti
Bertini	Bertini
OM̃IPS̃	OMnIPotenS
sempiterne	sempiterne
deus	deus
qui	qui
mira	mira
biliter	biliter
fulges	fulges
in	in
electis	electis
tuis	tuis
quos	quos
te	te

habi	habi
tatore	tatore
glorifi	glorifi
care	care
uoluisti	uoluisti
concede	concede
nos	nos
qs̃	quatenus
beati	beati
patris	patris
nr̃i	nostri
Bertini	Bertini
ita	ita
sollempnia	sollempnia
uenerari	uenerari
ut	ut
ei᷒	eius
suffragantib	suffragantibus
meritis	meritis
templũ	templum
tuum	tuum
mereamur	mereamur
fieri	fieri
Per	Per
Secreta	Secreta

Munera	Munera
nr̃a	nostra
tibi	tibi
dñe	domine
d̃s	deus
beati	beati
Bertini	Bertini
AURELII	AURELII
AUGUSTINI	AUGUSTINI
DOCTORIS	DOCTORIS
LIBER	LIBER
I᷒	Ius
HYPPONIENSIS	HYPPONIENSIS
EP̃I	EPiscopI
DE	DE
CIUITATE	CIUITATE
D̃I	DeI
INCIP̃	INCIPit
CONTR	CONTR
[	[
A	A
]	]
PAGANOS	PAGANOS
GL̃IOSIS	GLorIOSIS
SIMAM	SIMAM

CIUITATEM	CIUITATEM
DEI	DEI
SIUE	SIUE
IN	IN
HOC	HOC
TẼPORŨ	TEmPORUm
CURSU	CURSU
CŨ	CUm
INTER	INTER
impios	impios
pere	pere
grinatur	grinatur
ex	ex
fide	fide
uiuens	uiuens
siue	siue
in	in
illa	illa
stabilitate	stabilitate
sedis	sedis
ęternę	ęternę
quam	quam
nunc	nunc
expectat	expectat
ꝑ	per

pacien	pacien
tiã	tiam
quoadusq	quoadusque
iustitia	iustitia
c̃uertat᷑	conuertatur
in	in
iudiciũ	iudicium
deinceps	deinceps
adeptura	adeptura
ꝑ	per
excellentiã	excellentiam
uictoria	uictoria
ultima	ultima
&	et
pace	pace
ꝑfecta	perfecta
hoc	hoc
oꝑe	opere
ad	ad
te	te
institu	institu
to	to
&	et
mea	mea
ꝓmissione	promissione

debito	debito
defendere	defendere
ad	ad
uersus	uersus
eos	eos
qui	qui
c̃ditori	conditori
ei᷒	eius
deos	deos
suos	suos
ferunt	preferunt
fili	fili
km̃e	karissime
MARcelliNE	MARcelliNE
suscepi	suscepi
Magnũ	Magnum
opus	opus
&	et
arduũ	arduum
sed	sed
d̃s	deus
adiutor	adiutor
nr̃	noster
Nam	Nam
scio	scio

quib	quibus
EXPLIC̃	EXPLICit
TERCIA	TERCIA
ꝓpositio	propositio
INCIPIT	INCIPIT
QUARTA	QUARTA
QUARTA	QUARTA
PROPOSITIO	PROPOSITIO
EST	EST
ADŨsarii	ADUersarii
quę	quę
&	et
extrema	extrema
duos	duos
eẽ	esse
ordines	ordines
ouium	ouium
&	et
hircoꝝ	hircorum
alterũ	alterum
iustoꝝ	iustorum
alterum	alterum
peccatoꝝ	peccatorum
alios	alios
stare	stare

a	a
dextris	dextris
alios	alios
a	a
sinistris	sinistris
&	et
audire	audire
iustos	iustos
Venite	Venite
benedicti	benedicti
patͥs	patris
mei	mei
possidete	possidete
paratũ	paratum
uob̃	uobis
regnũ	regnum
a	a
constitutione	constitutione
mundi	mundi
Peccatorib	Peccatoribus
uͦ	uero
dici	dici
Discedite	Discedite
a	a
me	me

ma	ma
ledicti	ledicti
in	in
ignẽ	ignem
ęt̃nũ	ęternum
qui	qui
parat᷒	paratus
ẽ	est
diabolo	diabolo
&	et
an	an
gelis	gelis
ei᷒	eius
Arborẽ	Arborem
bonã	bonam
non	non
posse	posse
fruct᷒	fructus
malos	malos
fac͛e	facere
nec	nec
malã	malam
bonos	bonos
Uñ	Unde
&	et

saluator	saluator
loqͥt᷑	loquitur
ad	ad
iudeos	iudeos
Uos	Uos
de	de
patre	patre
diabolo	diabolo
estis	estis
&	et
concu	concu
QVIA	QVIA
LARGIENTE	LARGIENTE
DÑO	DomiNO
missarum	missarum
sollempnia	sollempnia
ter	ter
hodie	hodie
celebraturi	celebraturi
sum᷒	sumus
loqui	loqui
diu	diu
de	de
euange	euange
lica	lica

lectione	lectione
non	non
pos	pos
sumus	sumus
sed	sed
nos	nos
aliquid	aliquid
uel	uel
breuiter	breuiter
dicere	dicere
re	re
demptoris	demptoris
nr̃i	nostri
natiuitas	natiuitas
ipsa	ipsa
cõpellit	compellit
Quid	Quid
est	est
qͦd	quod
nascituro	nascituro
dño	domino
mundus	mundus
describitur	describitur
nisi	nisi
hoc	hoc

quod	quod
aꝑte	aperte
monstratur	monstratur
quia	quia
ille	ille
ueni	ueni
ebat	ebat
in	in
carne	carne
qͥ	qui
electos	electos
suos	suos
ascriber&	ascriberet
in	in
ęterni	ęterni
tate	tate
Cui	Cui
contra	contra
de	de
reꝓbis	reprobis
ꝑ	per
proph̃am	prophetam
dicitur	dicitur
Deleantur	Deleantur
de	de

libro	libro
uiuentiũ	uiuentium
&	et
cum	cum
iustis	iustis
non	non
scri	scri
bantur	bantur
Qui	Qui
bene	bene
&iam	etiam
in	in
b&hleem	bethleem
nascitur	nascitur
B&hleem	Bethleem
quippe	quippe
domus	domus
panis	panis
interpretat᷑	interpretatur
Ipse	Ipse
namq	namque
est	est
qͥ	qui
ait	ait
Ego	Ego

sum	sum
panis	panis
uiuus	uiuus
qͥ	qui
de	de
cęlo	cęlo
des	des
cendi	cendi
Locus	Locus
ergo	ergo
in	in
qͦ	quo
dñs	dominus
nasceretur	nasceretur
domus	domus
panis	panis
ante	ante
uocatus	uocatus
est	est
quia	quia
futurũ	futurum
ꝓfecto	profecto
erat	erat
ut	ut
ille	ille

ibi	ibi
ꝑ	per
materiã	materiam
carnis	carnis
apparer&	appareret
qui	qui
electoꝝ	electorum
m̃tes	mentes
interna	interna
satietate	satietate
reficer&	reficeret
Qui	Qui
non	non
in	in
parentũ	parentum
mentis	mentis
iudicans	iudicans
&	et
uulnerabili	uulnerabili
pa	pa
ternę	ternę
consolationis	consolationis
adhibens	adhibens
me	me
dicinam	dicinam

Sic	Sic
ille	ille
reuersus	reuersus
ad	ad
se	se
susceptionem	susceptionem
quam	quam
dilatam	dilatam
do	do
luit	luit
pacient̃	pacienter
expectauit	expectauit
Mortem	Mortem
quoq	quoque
Willelmi	Willelmi
iunio	iunio
ris	ris
qui	qui
magno	magno
ac	ac
trium	trium
phatori	phatori
anglorũ	anglorum
Willelmo	Willelmo
patri	patri

suo	suo
successerat	successerat
euidenti	euidenti
ua	ua
ticinio	ticinio
indicauit	indicauit
Erat	Erat
ille	ille
d̃i	dei
ser	ser
uus	uus
gl̃ose	gloriose
opinionis	opinionis
anselm᷒	anselmus
cantu	cantu
ꝓmisit	promisit
fuerat	fuerat
Prescriptus	Prescriptus
siqui	siqui
nationis	nationis
insister	insister
cui᷒dã	cuiusdam
militis	militis
in	in
statimq	statimque

subita	subita
expirauit	expirauit
Sic	Sic
i	i
terminata	terminata
et	et
a	a
claruit	claruit
&	et
cant	cant
qui	qui
ꝑsequenti	persequenti
s	s
redeundi	redeundi
facul	facul
cessit	cessit
Idem	Idem
d̃i	dei
seruus	seruus
Non	Non
oportet	oportet
a	a
LXXma	LXXma
usq	usque
in	in

oct̃	octaua
pasche	pasche
&	et
ab	ab
aduentu	aduentu
dñi	domini
usq	usque
p᷒	post
theophaniã	theophaniam
nupcias	nupcias
celebrari	celebrari
Conuenientib᷒	Conuenientibus
eis	eis
qͥ	qui
hoc	hoc
sacram̃tũ	sacramentum
celebrare	celebrare
desiderant	desiderant
pͥmo	primo
cauendũ	cauendum
&	et
diligentissime	diligentissime
ẽ	est
inqͥrend̃	inquirendum
ne	ne

sit	sit
int̃	inter
eos	eos
aliqͥd	aliquid
q̃d	quod
tanto	tanto
sacram̃to	sacramento
poᷤsit	possit
eẽ	esse
contrariũ	contrarium
Reqͥenduᷤ	Requiendus
ẽ	est
ętiã	ętiam
dili	dili
gent̃	genter
a	a
sac̃dote	sacerdote
amboꝝ	amborum
id÷	idest
uiri	uiri
et	et
mu	mu
lieris	lieris
assensus	assensus
Q̃d	Quod

si	si
uota	uota
amboꝝ	amborum
conuenerint	conuenerint
sacerdos	sacerdos
lecta	lecta
carta	carta
sponsalicii	sponsalicii
bñdicat	benedicat
arras	arras
dicens	dicens
BENEDIC	BENEDIC
dñe	domine
has	has
arras	arras
quas	quas
hodie	hodie
tradet	tradet
famulus	famulus
tuus	tuus
in	in
manu	manu
ancillę	ancillę
tuę	tuę
quem	quem

admodũ	admodum
benedixisti	benedixisti
abraam	abraam
cum	cum
saira	saira
ysaac	ysaac
cũ	cum
Rebeca	Rebeca
iacob	iacob
cũ	cum
rachel	rachel
Dona	Dona
suꝑ	super
eos	eos
dñe	domine
gr̃am	gratiam
benedic	benedic
PAPA	PAPA
VRBIS	VRBIS
ROME	ROME
EDITVS	EDITVS
SCRIPTORIS	SCRIPTORIS
LIBRI	LIBRI
LECTOR	LECTOR
MEMOR	MEMOR

d̃o	deo
dieb᷒	diebus
festis	festis
tantũmͦ	tantummodo
Inde	Inde
or̃o	oratio
Seqͥtur	Sequitur
Epl̃a	Epistula
Deinde	Deinde
Gradal̃	Gradalis
siue	siue
all̃a	alleluia
Postea	Postea
Eugl̃m	Euangelium
Inde	Inde
Offertoriũ	Offertorium
Postomodũ	Postomodum
seqͥtur	sequitur
or̃o	oratio
suꝑ	super
obl̃a	oblata
Qua	Qua
sub	sub
si	si
lentio	lentio

completa	completa
sacerdos	sacerdos
expansis	expansis
manib᷒	manibus
excelsa	excelsa
uoce	uoce
reuerenter	reuerenter
dicat	dicat
SUPER	SUPER
OBLATA	OBLATA
Oblata	Oblata
confessoris	confessoris
tui	tui
columbani	columbani
honore	honore
sint	sint
tibi	tibi
nr̃a	nostra
gra	gra
ta	ta
libamina	libamina
&	et
nr̃arum	nostrarum
apud	apud
te	te

supplicationum	supplicationum
effectum	effectum
obtineãt	obtineant
*	*
P	P
*	*
AD	AD
COMPLENDṼ	COMPLENDVm
Fac	Fac
nos	nos
quesumus	quesumus
domine	domine
beati	beati
confessoris	confessoris
tui	tui
colum	colum
bani	bani
digne	digne
sollempnia	sollempnia
celebrare	celebrare
qui	qui
largitatis	largitatis
tuae	tuae
preuent᷒	preuentus
munere	munere

laudabilis	laudabilis
uitę	uitę
cursum	cursum
glorioso	glorioso
fine	fine
compleuit	compleuit
*	*
P	P
*	*
EODEM	EODEM
DIE	DIE
VIGILIA	VIGILIA
SC̃E	SanCtE
CECILIAE	CECILIAE
VIRGINIS	VIRGINIS
SANctę	SANctę
CECILIAE	CECILIAE
mr̃is	martiris
tuę	tuę
quesumus	quesumus
domine	domine
intercessionibus	intercessionibus
nos	nos
fo	fo
ueas	ueas

acceperant	acceperant
&	et
tenuerant	tenuerant
s	sed
esau	esau
quidem	quidem
e	e
bron	bron
ciuitatem	ciuitatem
fratri	fratri
dans	dans
habitauit	habitauit
in	in
seir	seir
&	et
in	in
idumea	idumea
regnabat	regnabat
quam	quam
re	re
gionem	gionem
a	a
semetipso	semetipso
ita	ita
uocauit	uocauit

fratrem	fratrem
lentem	lentem
sibi	sibi
prepa	prepa
rantem	rantem
ad	ad
prandium	prandium
rubeum	rubeum
colorem	colorem
nimis	nimis
habentem	habentem
&	et
propterea	propterea
potius	potius
incitatus	incitatus
rogabat	rogabat
ut	ut
ei	ei
preberet	preberet
ad	ad
ci	ci
bum	bum
Qui	Qui
uendere	uendere
sibi	sibi

primatum	primatum
propt̃	propter
cibum	cibum
ꝑ	per
eius	eius
esuriem	esuriem
cimpulit	cimpulit
fratrẽ	fratrem
SICVT	SICVT
IN	IN
DI	DI
VINIS	VINIS
LITTERIS	LITTERIS
diuersa	diuersa
leguntur	leguntur
cantica	cantica
ita	ita
&	et
sp̃u	spiritu
sc̃o	sancto
lam̃tationes	lamentationes
diuersę	diuersę
Et	Et
sic̃	sicut
ꝓpͥe	proprie

appellatur	appellatur
liber	liber
salomonis	salomonis
cantica	cantica
canticoꝝ	canticorum
ita	ita
&	et
appellari	appellari
qͤũt	queunt
threni	threni
iheremię	iheremię
lamentationes	lamentationes
lam̃ta	lamenta
tionũ	tionum
	quia
sic̃	sicut
omnino	omnino
cellunt	precellunt
illa	illa
in	in
quib	quibus
sponsus	sponsus
ac	ac
sponsa	sponsa
dulvib	dulvibus

fruun	fruun
tur	tur
amplexibus	amplexibus
ita	ita
&	et
lam̃tationes	lamentationes
istę	istę
hoc	hoc
ĩ	in
nõe	nomine
dñi	domini
admonem᷒	admonemus
qͣntũ	quantum
posum᷒	posumus
&	et
cipim᷒	precipimus
ut	ut
qnͦ	quando
auditis	auditis
exponi	exponi
sacͣm̃tũ	sacramentum
scͥpt᷑ę	scripturę
narrantiᷤ	narrantis
quę	quę
gesta	gesta

s̃	sunt
prius	prius
illud	illud
q̃d	quod
lectũ	lectum
ẽ	est
credatis	credatis
sic	sic
gestũ	gestum
qͦmͦ	quomodo
lectũ	lectum
ẽ	est
ne	ne
subtracto	subtracto
fundam̃to	fundamento
rei	rei
gestę	gestę
qͣsi	quasi
in	in
aere	aere
quaeratiᷤ	quaeratis
edificare	edificare
Abrahã	Abraham
pat̃	pater
nr̃	noster

homo	homo
erat	erat
illis	illis
tẽporib	temporibus
fid̃liᷤ	fidelis
credens	credens
d̃o	deo
iustificat᷒	iustificatus
ex	ex
fide	fide
sic̃	sicut
script᷑a	scriptura
dic̃	dicit
&	et
uet᷒	uetus
&	et
noua	noua
Suscep̃	Suscepit
filiũ	filium
de	de
sara	sara
uxore	uxore
iã	iam
in	in
senectute	senectute

utͥsq	utrisque
c̃stitutiᷤ	constitutis
ex	ex
magna	magna
desꝑatiõe	desperatione
,	,
s	sed
scd̃m	secundum
hominẽ	hominem
Qͥd	Quid
aut̃	autem
de	de
deo	deo
ñ	non
sꝑandũ	sperandum
cui	cui
nichil	nichil
difficile	difficile
ẽ	est
qͥ	qui
sic	sic
fac̃	facit
magna	magna
quomͦ	quomodo
parua	parua

sic	sic
suscitat	suscitat
mortuoᷤ	mortuos
qͦmͦ	quomodo
creat	creat
uiuos	uiuos
Si	Si
pictor	pictor
eadẽ	eadem
arte	arte
fac̃	facit
murem	murem
sudario	sudario
porrigit᷑	porrigitur
ad	ad
altare	altare
q̃d	quod
sudariũ	sudarium
ponitur	ponitur
in	in
cornu	cornu
alta	alta
Calix	Calix
in	in
latere	latere

oblata	oblata
in	in
altari	altari
cõponit᷑	componitur
ñ	non
post	post
tergũ	tergum
Lętanię	Lętanię
ita	ita
cęlebraᷠt᷑	cęlebrantur
in	in
uigiliis	uigiliis
paschę	paschę
ut	ut
nr̃	noster
mos	mos
olim	olim
obtinuit	obtinuit
id	id
est	est
post	post
baptismũ	baptismum
ꝑ	per
sepnariũ	sepnarium
&	et

quinariũ	quinarium
&	et
ternariũ	ternarium
numerum	numerum
OFFICIALIS	OFFICIALIS
LIBER	LIBER
GLORIOSISSIME	GLORIOSISSIME
IMPERATOR	IMPERATOR
ET	ET
MAGNIFICEN	MAGNIFICEN
sime	sime
ac	ac
centies	centies
inuictissime	inuictissime
a	a
d̃o	deo
coronate	coronate
nec	nec
n	n
&	et
conseruate	conseruate
atq	atque
conseruande	conseruande
seruus	seruus
ego	ego

ur̃	uester
A	A
LARIUS	LARIUS
quãuis	quamuis
minimus	minimus
om̃iũ	omnium
Afficiebar	Afficiebar
oli	oli
desiderio	desiderio
ut	ut
scirẽ	scirem
rationẽ	rationem
aliquã	aliquam
de	de
ordine	ordine
nr̃ę	nostrę
missę	missę
quã	quam
consuęto	consuęto
more	more
cęlebram᷒	cęlebramus
&	et
amplius	amplius
ex	ex
diuersitate	diuersitate

q	q
solet	solet
fieri	fieri
in	in
ea	ea
hoc	hoc
est	est
q̃d	quod
aliquotiens	aliquotiens
una	una
epistola	epistola
legit᷑	legitur
aliqͦti	aliquoti
ens	ens
duę	duę
&	et
cętera	cętera
talia	talia
simulq	simulque
de	de
ceteris	ceteris
officiis	officiis
Pręterita	Pręterita
ꝓxim	proxim
priis	priis

eoꝝ	eorum
uerbis	uerbis
utens	utens
quę	quę
apta	apta
erant	erant
meo	meo
studio	studio
temperaui	temperaui
Interdum	Interdum
autẽ	autem
quę	quę
manifesta	manifesta
non	non
dubiũ	dubium
uidebantur	uidebantur
uera	uera
ratione	ratione
firmaui	firmaui
Et	Et
contra	contra
quęq.	quęque
in	in
eiusdem	eiusdem
libri	libri

margine	margine
litteras	litteras
doctoꝝ	doctorum
quos	quos
premisi	premisi
ex	ex
initio	initio
nominis	nominis
e	e
regione	regione
figere	figere
curaui	curaui
Propter	Propter
quod	quod
lege	lege
securus	securus
&	et
ꝑfice	perfice
quę	quę
monui	monui
deuotus	deuotus
Explicit	Explicit
PROLOG᷒	PROLOGus
INCIPIVNT	INCIPIVNT
CAPITVLA	CAPITVLA

I	I
xp̃i	Christi
cõmunionẽ	communionem
uerũ	uerum
corpus	corpus
ei᷒	eius
&	et
sanguinẽ	sanguinem
esse	esse
II	II
Q̃d	Quod
hoc	hoc
mysteriũ	mysterium
xp̃i	Christi
nullus	nullus
fideliũ	fidelium
debeat	debeat
ignorare	ignorare
III	III
Quid	Quid
sint	sint
sacramenta	sacramenta
uel	uel
quare	quare
dicantur	dicantur

IIII	IIII
Vtrũ	Vtrum
sub	sub
figura	figura
an	an
in	in
ueritate	ueritate
hoc	hoc
mysticũ	mysticum
fiat	fiat
sacramentũ	sacramentum
V	V
Quid	Quid
sit	sit
inter	inter
immolationes	immolationes
ueterũ	ueterum
figurasq.	figurasque
legaliũ	legalium
&	et
int̃	inter
sacramentũ	sacramentum
dñici	dominici
corporis	corporis
&	et

sanguinis	sanguinis
puritate	puritate
celesis	celesis
desid̃ii	desiderii
gaudent	gaudent
Erat	Erat
eneũ	eneum
quia	quia
multi	multi
sũt	sunt
qͥ	qui
dicunt	dicunt
mente	mente
seruiuim᷒	seruiuimus
legi	legi
dei	dei
carne	carne
aut̃	autem
legi	legi
peccati	peccati
Erat	Erat
ante	ante
templi	templi
fores	fores
positum	positum

quia	quia
pauci	pauci
sunt	sunt
qui	qui
renuntiant	renuntiant
om̃ib	omnibus
q̃	que
possident	possident
ut	ut
ad	ad
ostium	ostium
portic᷒	porticus
appro	appro
pinquent	pinquent
Portic᷒	Porticus
siqͥd̃	siquidem
templi	templi
ẽ	est
ut	ut
suꝑi᷒	superius
dixim᷒	diximus
renuntiatõ	renuntiatio
mundi	mundi
In	In
hac	hac

conuersionis	conuersionis
De	De
altari	altari
aureo	aureo
⁊	et
mensa	mensa
aurea	aurea
⁊	et
candelabro	candelabro
IN	IN
hoc	hoc
templo	templo
ẽ	est
altare	altare
aureũ	aureum
est	est
m̃sa	mensa
aurea	aurea
sunt	sunt
⁊	et
candelabra	candelabra
de	de
auro	auro
purissi	purissi
mo	mo

oꝑis	operis
exemplum	exemplum
Fum᷒	Fumus
thimiamatũ	thimiamatum
qͥ	qui
suꝑi᷒	superius
ascendit	ascendit
ẽ	est
intentõ	intentio
oratõnis	orationis
q̃	que
ex	ex
affectu	affectu
cordis	cordis
ad	ad
desid̃anda	desideranda
celestia	celestia
tendit	tendit
m̃sa	mensa
uͦ	uero
aurea	aurea
ẽ	est
diuina	diuina
scͥptura	scriptura
panes	panes

sunt	sunt
apostoli	apostoli
siue	siue
eoꝝ	eorum
successores	successores
ex	ex
quoꝝ	quorum
actib	actibus
tanqͣm	tanquam
ex	ex
pa	pa
nib	nibus
reficiunt᷑	reficiuntur
fideliũ	fidelium
mentes	mentes
Qui	Qui
panes	panes
ꝓpositõnis	propositionis
ꝯuenient̃	conuenienter
possunt	possunt
appellar	appellar
quia	quia
ad	ad
imitandũ	imitandum
ꝓponunt᷑	proponuntur

uniũso	uniuerso
orbi	orbi
Decẽ	Decem
candelabra	candelabra
sũt	sunt
decem	decem
legis	legis
cepta	precepta
luc̃ne	lucerne
lumen	lumen
doctͥne	doctrine
Possunt	Possunt
hec	hec
⁊	et
alit̃	aliter
dici	dici
Sit	Sit
gͥ	igitur
altare	altare
dilectõ	dilectio
mensa	mensa
lectõ	lectio
cande	cande
INCIPIT	INCIPIT
PROLOG᷒	PROLOGus

IN	IN
VITÃ	VITAm
SC̃I	SanCtI
AGERICI	AGERICI
Impellitis	Impellitis
me	me
ac	ac
trahitis	trahitis
uiolentia	uiolentia
amabili	amabili
fr̃s	fratres
km̃i	karissimi
ut	ut
in	in
die	die
festiuitatis	festiuitatis
Sc̃i	Sancti
ac	ac
uene	uene
rabilis	rabilis
patris	patris
nr̃i	nostri
AGERICI	AGERICI
de	de
horto	horto

uir	uir
tutum	tutum
ipsius	ipsius
fecundissimo	fecundissimo
quosdam	quosdam
floscu	floscu
los	los
et	et
uirentia	uirentia
quęlibet	quęlibet
odoramenta	odoramenta
decer	decer
pam	pam
eaq.	eaque
ad	ad
mensam	mensam
leticię	leticię
cõmunis	communis
fer	fer
culo	culo
litterarum	litterarum
cõposita	composita
offeram	offeram
sicq.	sicque
reple	reple

am	am
desiderii	desiderii
ur̃i	uestri
appetitum	appetitum
particulãq.	particulamque
bonam	bonam
acceptam	acceptam
a	a
dño	domino
uobis	uobis
ex	ex
caritate	caritate
cõmunicem	communicem
Bona	Bona
ẽ	est
ac	ac
laudabilis	laudabilis
plutimũ	plutimum
intentio	intentio
EXPLICIT	EXPLICIT
DIES	DIES
QUART᷒	QUARTus
INCIP̃	INCIPit
LIB̃	LIBer
QͥNT᷒	QuiNTus

QVI	QVI
VINDE	VINDE
MIAM	MIAM
COL	COL
LIGIT	LIGIT
uasa	uasa
prius	prius
quibus	quibus
uinum	uinum
infundit᷑	infunditur
mundare	mundare
consueuit	consueuit
ne	ne
sor	sor
des	des
aliqua	aliqua
uini	uini
gr̃am	gratiam
decoloret	decoloret
Quid	Quid
enĩ	enim
prodest	prodest
ponerę	ponerę
uitę̃	uitęm
ordine	ordine

fodere	fodere
quot	quot
annis	annis
aut	aut
aratris	aratris
sulcos	sulcos
ducere	ducere
putare	putare
subrigere	subrigere
adiungere	adiungere
ulmis	ulmis
&	et
quodam	quodam
conubio	conubio
copulare	copulare
si	si
tanto	tanto
labore	labore
uina	uina
quesita	quesita
in	in
uase	uase
coacescant	coacescant
matutinos	matutinos
quoq	quoque

solis	solis
ort᷒	ortus
si	si
quis	quis
spectare	spectare
desiderat	desiderat
emundat	emundat
ocl̃os	oculos
suos	suos
nequid	nequid
pulueris	pulueris
neqͥd	nequid
purgam̃toꝝ	purgamentorum
ocl̃is	oculis
ei᷒	eius
insideat	insideat
quo	quo
tu	tu
endis	endis
hebetet᷑	hebetetur
optut᷒	optutus
neue	neue
aliqua	aliqua
caligo	caligo
nebulosa	nebulosa

corporeos	corporeos
uisus	uisus
spectantis	spectantis
ob	ob
uestrę	uestrę
quare	quare
hunc	hunc
sermonẽ	sermonem
necesse	necesse
habui	habui
uob̃	uobis
ꝓmere	promere
Ex	Ex
quo	quo
hic	hic
sumus	sumus
euntes	euntes
ad	ad
ęccl̃am	ęcclesiam
&	et
redeuntes	redeuntes
pauperes	pauperes
int̃pellant	interpellant
nos	nos
&	et

nos	nos
arbitran	arbitran
tur	tur
laborare	laborare
in	in
uob̃	uobis
Expectant	Expectant
aliquid	aliquid
&	et
a	a
nob̃	nobis
damus	damus
quãtum	quantum
habem᷒	habemus
damus	damus
sicut	sicut
possumus	possumus
Nũquid	Numquid
tam̃	tamen
ad	ad
eorũ	eorum
necessitatẽ	necessitatem
supplendã	supplendam
idonei	idonei
sumus	sumus

Quia	Quia
gͦ	ergo
ad	ad
eorum	eorum
necessitatẽ	necessitatem
implendã	implendam
idonei	idonei
non	non
sumus	sumus
uel	uel
ad	ad
uos	uos
legati	legati
ipsorũ	ipsorum
sumus	sumus
Audistis	Audistis
laudas	laudas
tis	tis
d̃o	deo
gr̃as	gratias
egistis	egistis
Sem̃	Semen
accepistis	accepistis
ũba	uerba
reddidistis	reddidistis

Laudes	Laudes
istae	istae
ur̃ę	uestrę
grauant	grauant
nos	nos
poti	poti
us	us
&	et
in	in
periculũ	periculum
mittunt	mittunt
Toleram᷒	Toleramus
illas	illas
&	et
tremimus	tremimus
int̃	inter
illas	illas
Tam̃	Tamen
fr̃s	fratres
mei	mei
iste	iste
lau	lau
des	des
ur̃ę	uestrę
folia	folia

sunt	sunt
arborũ	arborum
fructus	fructus
quęritur	quęritur
EXPLICIT	EXPLICIT
ITEM	ITEM
EIUSDEM	EIUSDEM
DE	DE
VERBIS	VERBIS
DÑI	DomiNI
IN	IN
EUGL̃O	AUanGeLiO
SCD̃M	SeCunDuM
MATH̃M	MATHeuM
DE	DE
PVERO	PVERO
CENTVRIONIS	CENTVRIONIS
&	et
VERBIS	VERBIS
EI᷒	EIus
INDIGNṼ	INDIGNVm
SE	SE
PRESENTIA	PRESENTIA
DÑI	DomiNI
debita	debita

iniqͥtatib	iniquitatibus
ei᷒	eius
EXPLIC̃	EXPLICit
DE	DE
PSA	PSA
MO	MO
CENTESIMO	CENTESIMO
VICESIMO	VICESIMO
NONO	NONO
INCIPIT	INCIPIT
DE	DE
PSALMO	PSALMO
CENTESIMO	CENTESIMO
TRICESIMO	TRICESIMO
IN	IN
ISTO	ISTO
PSALMO	PSALMO
cõm̃dat᷑	commendatur
nob̃	nobis
humilitas	humilitas
se	se
ui	ui
d̃i	dei
&	et
fidelis	fidelis

cui᷒	cuius
uoce	uoce
cantat᷑	cantatur
q̃d	quod
ẽ	est
uni	uni
uersũ	uersum
corp᷒	corpus
xp̃i	Christi
Sepe	Sepe
enĩ	enim
admonuim᷒	admonuimus
cari	cari
tatẽ	tatem
ur̃am	uestram
ñ	non
qͣsi	quasi
uni᷒	unius
hominis	hominis
cantantis	cantantis
u	u
cẽ	cem
accipi	accipi
debere	debere
sed	sed

s̃t	sunt
M	M
ti	ti
enĩ	enim
s̃t	sunt
in	in
seipsis	seipsis
un᷒	unus
s̃t	sunt
in	in
illo	illo
qͥ	qui
un᷒	unus
ẽ	est
Ipsũ	Ipsum
ẽ	est
etiã	etiam
tẽplũ	templum
d̃i	dei
de	de
qͦ	quo
apl̃s	apostolus
dicit	dicit
Tẽp	Temp
enĩ	enim

d̃i	dei
sc̃m	sanctum
ẽ	est
q̃d	quod
estis	estis
uos	uos
Om̃s	Omnes
qͥ	qui
credd̃t	creddunt
in	in
xp̃m	Christum
&	et
sic	sic
cred̃t	credunt
ut	ut
diligant	diligant
hoc	hoc
ẽ	est
crede	crede
in	in
xp̃m	Christum
diligere	diligere
xp̃m	Christum
NON	NON
qͦmͦ	quomodo

demones	demones
fontẽ	fontem
uenirent	uenirent
nͥ	nisi
aliqͣ	aliqua
die	die
lauarent᷑	lauarentur
Istũ	Istum
aut̃	autem
diem	diem
poti᷒	potius
ad	ad
hoc	hoc
electũ	electum
qͦ	quo
cena	cena
dñica	dominica
anniuersarie	anniuersarie
celebͣt᷑	celebratur
&	et
qͥa	quia
concessũ	concessum
ẽ	est
hoc	hoc
baptismũ	baptismum

accept᷑is	accepturis
,	,
multi	multi
cũ	cum
his	his
la	la
uare	uare
uoluer̃	uoluerunt
ieiuniũq	ieiuniumque
laxare	laxare
his	his
ꝓut	prout
potui	potui
disputati	disputati
moneo	moneo
ea	ea
quę	quę
locut᷒	prelocutus
sũ	sum
serues	serues
qͣntũ	quantum
potes	potes
ut	ut
ęccl̃ę	ęcclesię
d	d

Ianuario	Ianuario
AUgUSTINUS	AUgUSTINUS
Lectis	Lectis
litt͛is	litteris
tuis	tuis
ubi	ubi
me	me
cõmonuisti	commonuisti
ut	ut
debitũ	debitum
redderẽ	redderem
de	de
residuis	residuis
enodandis	enodandis
questionib᷒	questionibus
qͣs	quas
iã	iam
lon	lon
ge	ge
añ	ante
quesiueras	quesiueras
gͣtissimũ	gratissimum
mͥ	michi
atq	atque
karissimũ	karissimum

desideriũ	desiderium
Incipit	Incipit
sũma	summa
magistͥ	magistri
alani	alani
de	de
ꝯfessione	confessione
et	et
penitencia	penitencia
Quoniam	Quoniam
circa	circa
confessiones	confessiones
aĩaꝝ	animarum
ꝑicl̃a	pericula
sunt	sunt
et	et
difficultates	difficultates
qñ	quandoque
emergunt	emergunt
Id̃o	Ideo
ad	ad
honorem	honorem
d̃i	dei
sc̃iq	sanctique
Nicholai	Nicholai

facili᷒	facilius
lector	lector
q̃	que
uelit	uelit
ualeat	ualeat
inuenire	inuenire
Cui᷒	Cuius
tͣctat᷒	tractatus
rubrice	rubrice
sunt	sunt
he	he
I	I
capitulum	capitulum
Qͦ	Quo
temꝑe	tempore
inceꝑit	inceperit
ꝯfessio	confessio
II	II
Quare	Quare
sit	sit
instituta	instituta
confessio	confessio
III	III
Cui	Cui
facienda	facienda

sit	sit
confessio	confessio
Quando	Quando
sit	sit
confitendum	confitendum
V	V
Que	Que
precipue	precipue
ĩ	in
ꝯfessiõe	confessione
reqͥrũt᷑	requiruntur
VI	VI
Q̃	Que
sint	sint
necc̃a	neccessaria
ad	ad
uerã	ueram
peñiam	penitentiam
VII	VII
De	De
allocutiõe	allocutione
sac͛dotis	sacerdotis
et	et
ĩductiõe	inductione
ad	ad

ꝯfitẽd̃	confitendum
VIII	VIII
De	De
cirꝯstanciis	circumstanciis
quas	quas
pcc̃or	peccator
tenet᷑	tenetur
ꝯfiteri	confiteri
IX	IX
Utrum	Utrum
cirꝯstancie	circumstancie
agrauent	agrauent
pcc̃m	peccatum
X	X
De	De
int̃rogationib	interrogationibus
a	a
sac̃dote	sacerdote
faciendis	faciendis
XI	XI
De	De
generibus	generibus
abusionum	abusionum
XII	XII
De	De

officio	officio
et	et
debito	debito
sac̃dotis	sacerdotis
erga	erga
penitẽtes	penitentes
XIII	XIII
Qͥs	Quis
pcc̃a	peccata
dimͭtat	dimittat
et	et
ꝑ	per
q̃	que
mortalia	mortalia
siue	siue
uenialia	uenialia
dimittãt᷑	dimittantur
XIIII	XIIII
De	De
modo	modo
penitencie	penitencie
ꝓ	pro
quolibet	quolibet
peccato	peccato
XV	XV

Que	Que
debent	debent
considerari	considerari
in	in
inposione	inposione
penitencie	penitencie
Non	Non
·H·	enim
nosm	nosmet
ip̃os	ipsos
dicamus	predicamus
s	sed
ih̃m	iesum
xp̃m	Christum
do	do
minũ	minum
nr̃m	nostrum
noᷤ	nos
aũ	autem
seruos	seruos
ur̃os	uestros
ꝑ	per
ih̃m	iesum
qm̃	quoniam
d̃s	deus

qͥ	qui
dixit	dixit
de	de
tene	tene
bris	bris
lucẽ	lucem
splen	splen
desc̃e	descere
ipse	ipse
illux̃	illuxit
in	in
cordib	cordibus
nr̃is	nostris
ad	ad
illuminaci	illuminaci
onẽscĩe	onemscientie
clarita	clarita
tis	tis
d̃i	dei
in	in
facie	facie
xͥ	Christi
ih̃u	iesu
nedico	nedico
gl̃ie	glorie

xp̃i	Christi
non	non
·H·	enim
⁊	et
c̃	cetera
l̃	uel
ita	ita
ꝯtinua	continua
ꝯm̃dam᷒	commendamus
nos	nos
in	in
manifestacione	manifestacione
ũi	ueri
tatis	tatis
⁊	et
cet̃a	cetera
ͭalia	talia
facimus	facimus
⁊	et
h̃	hec
ꝓp̃	propter
xp̃m	Christum
ñ	non
·H·	enim
di.	predicamus

nos	nos
m	met
ip̃os	ipsos
s	sed
ih̃m	iesum
xp̃m	Christum
do.	dominum
nos.	nostrum
.i.	idest
dicacio	predicacio
nr̃a	nostra
non	non
tendit	tendit
ad	ad
gl̃iam	gloriam
nr̃am	nostram
l̃	uel
ad	ad
lucra	lucra
nr̃a	nostra
s	sed
ad	ad
gl̃iam	gloriam
xͥ	Christi
ꝙ̃	quem

predicamus	predicamus
saluato	saluato
rem	rem
⁊	et
dñm	dominum
nr̃m	nostrum
eẽ	esse
illũ	illum
dicam᷒	predicamus
eẽ	esse
dñm	dominum
Nos	Nos
aũ	autem
dñis	dominis
eẽ	esse
seruos	seruos
.i.	idest
minis	minis
stros	stros
ur̃os	uestros
⁊	et
h̃	hoc
ꝑ	per
xp̃m	Christum
qui	qui

nobis	nobis
h̃	hoc
iniunx̃	iniunxit
hoc	hoc
aut̃	autem
facimus	facimus
qm̃	quoniam
d̃s	deus
ip.	ipse
illux̃	illuxit
in	in
cor.	cordibus
no.	nostris
.i.	idest
se	se
qͥ	qui
ẽ	est
lumen	lumen
nobis	nobis
infu	infu
n	n
dit	dit
qͥ	qui
dixit	dixit
.i.	idest

lux	lux
fc̃a	facta
eẽt	esset
qua	qua
illuminaret᷑	illuminaretur
ꝙ	quod
sñ	sine
luce	luce
fu	fu
erat	erat
tenebrosum	tenebrosum
p᷒ea	postea
e	e
uõ	uero
accedente	accedente
luce	luce
ꝙ	quod
fc̃m	factum
est	est
melius	melius
reddr᷑	redditur
in	in
qͦ	quo
ꝓfi	profi
cientis	cientis

hõis	hominis
affectio	affectio
sigc̃atur	significatur
uñ	unde
apl̃s	apostolus
loquẽs	loquens
tore	tore
&	et
loquutus	loquutus
ẽ	est
eis	eis
multa	multa
in	in
par	par
abolis	abolis
dicens	dicens
Exiit	Exiit
qui	qui
semin	semin
at	at
seminare	seminare
semen	semen
suum	suum
Et	Et
dum	dum

semi	semi
minores	minores
	et
subditi	subditi
ĩ	in
eccl̃ia	ecclesia
intelligunt᷑	intelliguntur
qui	qui
ñ	non
ascendunt	ascendunt
in	in
nauim	nauim
ñdum	nondum
cele	cele
stib	stibus
misteriis	misteriis
imbuti	imbuti
cum	cum
xp̃o	Christo
in	in
ꝑabolis	parabolis
Lucas	Lucas
ꝑ	per
similitudi	similitudi
nẽ	nem

q̃d	quod
idem	idem
ẽ	est
Marcus	Marcus
Dicebat	Dicebat
eis	eis
in	in
doctrina	doctrina
sua	sua
Cap̃	Capitulum
lxxii	lxxii
Exiit	Exiit
Qui	Qui
discipl̃is	discipulis
loq̃bat᷑	loquebatur
sacramenta	sacramenta
exiit	exiit
seminare	seminare
ũ	uer
bum	bum
dei	dei
in	in
turbas	turbas
	et
parabolas	parabolas

ut	ut
iuxta	iuxta
uarias	uarias
uoluntates	uoluntates
s.	scilicet
	et
sentencias	sentencias
suas	suas
diũsas	diuersas
reci	reci
piant	piant
disciplinas	disciplinas
s.	scilicet
ut	ut
uiden	uiden
tes	tes
ñ	non
uideant	uideant
	et
c̃	cetera
Nota	Nota
	quia
triplex	triplex
ẽ	est
sem̃	semen

Sem̃	Semen
seminatum	seminatum
pulueree	pulueree
cogitationis	cogitationis
obscuret	obscuret
Que	Que
tamen	tamen
ñ	non
pulsare	pulsare
rectoris	rectoris
animum	animum
nequeunt	nequeunt
s	sed
festinare	festinare
necesse	necesse
est	est
ut	ut
repugnatione	repugnatione
uincantur	uincantur
ne	ne
uitium	uitium
quod	quod
ꝑ	per
suggestionem	suggestionem
temptat	temptat

denunciet	denunciet
	et
grex	grex
qui	qui
pastoris	pastoris
uocẽ	uocem
mores	mores
q	que
sequitur	sequitur
ꝑ	per
exempla	exempla
melius	melius
quã	quam
ꝑ	per
u͛ba	uerba
gradiatur	gradiatur
Qui	Qui
enim	enim
loci	loci
sui	sui
necessitate	necessitate
exigitur	exigitur
summa	summa
dic̃e	dicere
hac	hac

eadem	eadem
necessitate	necessitate
conpellitur	conpellitur
summa	summa
monstrare	monstrare
Illa	Illa
namq	namque
uox	uox
faciem	faciem
rubore	rubore
uestiet	uestiet
aut	aut
pallore	pallore
confũdet	confundet
cui᷒	cuius
labia	labia
contrahentur	contrahentur
aut	aut
salient	salient
toxica	toxica
bit᷑	bitur
lingua	lingua
genua	genua
trement	trement
manus	manus

ꝓt̃uiet	proteruiet
se	se
ip̃m	ipsum
nugis	nugis
nr̃is	nostris
conuincet	conuincet
obnoxium	obnoxium
In	In
qͥb	quibus
fuit	fuit
ꝓpositi	propositi
semꝑ	semper
a	a
nugis	nugis
ad	ad
bona	bona
tran	tran
sire	sire
seria	seria
⁊	et
ad	ad
id	id
quod	quod
decet	decet
aut	aut

ꝓdest	prodest
resti	resti
tuere	tuere
uitam	uitam
Qͥ	Qui
aut̃	autem
iustũ	iustum
rehensioni	reprehensioni
lo	lo
cũ	cum
uid̃it	uiderit
ea	ea
ex	ex
caritate	caritate
licent̃	licenter
utat᷑	utatur
⁊	et
de	de
em̃	emen
datione	datione
mea	mea
acquirat	acquirat
sibi	sibi
⁊	et
possideat	possideat

	pre
mium	mium
uite	uite
Scio	Scio
enĩ	enim
quia	quia
in	in
multiloquio	multiloquio
pecc̃m	peccatum
ñ	non
deest	deest
s	sed
inuito	inuito
⁊	et
in	in
caritate	caritate
dei	dei
ex	ex
hortor	hortor
lectorẽ	lectorem
qͦ	quo
mei	mei
memor	memor
in	in
orationibus	orationibus

suis	suis
impetret	impetret
ut	ut
filius	filius
dei	dei
uiui	uiui
⁊	et
uirginis	uirginis
intemerate	intemerate
deus	deus
homo	homo
manifestet	manifestet
se	se
ipsũ	ipsum
⁊	et
palam	palam
faciat	faciat
uiam	uiam
qua	qua
nob̃	nobis
incedendum	incedendum
ẽ	est
in	in
bñplacito	beneplacito
suo	suo

⁊	et
dirigat	dirigat
in	in
eo	eo
gressus	gressus
nostros	nostros
AMeN	AMeN
Que	Que
aũ	autem
Liber	Liber
sc̃e	sancte
marie	marie
pontiniaci	pontiniaci
Finito	Finito
libro	libro
reddantur	reddantur
iura	iura
magistro	magistro
D̃s	Deus
qui	qui
hodiernã	hodiernam
diẽ	diem
apl̃orum	apostolorum
tuorum	tuorum
petri	petri

&	et
pauli	pauli
mar	mar
tirio	tirio
consecrasti	consecrasti
da	da
eccl̃ie	ecclesie
tue	tue
eorum	eorum
in	in
omnib	omnibus
sequi	sequi
preceptũ	preceptum
ꝑ	per
quos	quos
religionis	religionis
sumpsit	sumpsit
exordiũ	exordium
ꝑ	per
sc̃r	secreta
Hostias	Hostias
dñe	domine
quas	quas
nomini	nomini
tuo	tuo

sacrandas	sacrandas
offerimus	offerimus
apl̃ica	apostolica
ꝓ	pro
sequatur	sequatur
oratio	oratio
ꝑ	per
quam	quam
nos	nos
expia	expia
INCIPIT	INCIPIT
PREFACIO	PREFACIO
MAGISTRI	MAGISTRI
GAU	GAU
FRIDI	FRIDI
MONEMUTENSIS	MONEMUTENSIS
IN	IN
historia	historia
BRITONUM	BRITONUM
CUM	CUM
mecũ	mecum
multa	multa
⁊	et
de	de
multis	multis

sepius	sepius
animo	animo
reuoluens	reuoluens
in	in
ystoriam	ystoriam
regũ	regum
britannie	britannie
inciderem	inciderem
in	in
mir̃	mirum
q̃d	quod
ĩfra	infra
men	men
tionem	tionem
quam	quam
de	de
eis	eis
Gildas	Gildas
⁊	et
beda	beda
lu	lu
culento	culento
tͣctu	tractu
fecerant	fecerant
nichil	nichil

rent	rent
⁊	et
a	a
multis	multis
populis	populis
qͧasi	quasi
inscͥpta	inscripta
io	io
cunde	cunde
⁊	et
memorit̃	memoriter
dicentur	predicentur
tali	tali
a	a
mͥ	michi
⁊	et
de	de
talib	talibus
multociens	multociens
cogitanti	cogitanti
optu	optu
lit	lit
Walterus	Walterus
oxinefordensis	oxinefordensis
archi	archi

diacon᷒	diaconus
uir	uir
in	in
oratoria	oratoria
arte	arte
atq	atque
in	in
ex	ex
oticis	oticis
ystoriis	ystoriis
erudit᷒	eruditus
quendam	quendam
brita	brita
BRitannia	BRitannia
insularum	insularum
oct	oct
dentali	dentali
occeano	occeano
int̃	inter
gall	gall
niã	niam
sita	sita
dccc	dccc
milia	milia
in	in

long	long
in	in
latũ	latum
cõtinens	continens
quicquid	quicquid
usui	usui
congruit	congruit
in	in
deficient	deficient
te	te
ministrat	ministrat
Om̃i	mni
⁊	et
enĩ	enim
geñ	gener
cãpos	campos
late	late
sparsos	sparsos
h̃t	habet
⁊	et
coll	coll
pollenti	prepollenti
culture	culture
aptos	aptos
in	in

diũsitateᷤ	diuersitates
ubertate	ubertate
glebe	glebe
tp̃rib	temporibus
niũt	niunt
h̃t	habet
⁊	et
nemora	nemora
uniũsis	uniuersis
geñib	generibus
repleta	repleta
⁊	et
quoꝝ	quorum
in	in
saltͥ	salti
nandis	nandis
animaliũ	animalium
pastib.	pastibus
ueniũt	ueniunt
⁊	et
a	a
uolantib.	uolantibus
apib.	apibus
ũsoꝝ	uersorum
coloꝝ	colorum

mella	mella
distͥbuit	distribuit
ta	ta
sub	sub
aeriis	aeriis
montib.	montibus
amen	amen
rentia	rentia
in	in
qͥb.	quibus
fontes	fontes
lucidi	lucidi
riuos	riuos
leni	leni
murmure	murmure
man	man
n᷒	nus
suauis	suauis
soporis	soporis
in	in
ripis	ripis
uenietis	uenietis
requiem	requiem
animab	animabus
uestris	uestris

Iugũ	Iugum
enĩ	enim
meũ	meum
suaue	suaue
est	est
et	et
onus	onus
meum	meum
leue	leue
Om̃ips̃	Omnipotens
sempiterne	sempiterne
deus	deus
adesto	adesto
magne	magne
pietatis	pietatis
tue	tue
misteriis	misteriis
adesto	adesto
sacramentiis	sacramentiis
et	et
ad	ad
creandos	creandos
nouos	nouos
popl̃os	populos
quos	quos

tibi	tibi
fons	fons
baptismacis	baptismacis
parturit	parturit
sp̃m	spiritum
adoptionis	adoptionis
emitte	emitte
Ut	Ut
quod	quod
nostre	nostre
humi	humi
litatis	litatis
genrendum	genrendum
ẽ	est
misterio	misterio
tue	tue
uirtutis	uirtutis
inplea	inplea
tur	tur
effectu	effectu
per	per
dominũ	dominum
Dñs	Dominus
uobiscum	uobiscum
Et	Et

cũ	cum
sp̃u	spiritu
tuo	tuo
Sursum	Sursum
corda	corda
Habemus	Habemus
ad	ad
domi	domi
nũ	num
Gr̃as	Gratias
agamus	agamus
domino	domino
deo	deo
nostro	nostro
Dignũ	Dignum
et	et
iustum	iustum
est	est
prefatio	prefatio
Uere	Uere
dignũ	dignum
&	et
iustũ	iustum
est	est
equũ	equum

&	et
salutare	salutare
Noᷤ	Nos
tibi	tibi
semꝑ	semper
&	et
ubiq	ubique
gr̃as	gratias
agere	agere
dñe	domine
sc̃e	sancte
pater	pater
omnipotens	omnipotens
et̃ne	eterne
d̃s	deus
Qui	Qui
inuisibili	inuisibili
potentia	potentia
sa	sa
sit	sit
carnis	carnis
substãtia	substantia
testant᷑	testantur
sepuᷝchra	sepulchra
Quis	Quis

parẽtum	parentum
amicoꝝ	amicorum
fideliũ	fidelium
ꝙͣlib&	quamlibet
dilecti	dilecti
sui	sui
tangere	tangere
scaturien	scaturien
u͛mib	uermibus
carnẽ	carnem
potest	potest
Caro	Caro
itaq	itaque
cũ	cum
c̃cupiscit	concupiscit
p	p
set᷑	setur
qͥd	quid
sit	sit
exanimis	exanimis
&	et
intelligit᷑	intelligitur
qͥd	quid
amat᷑	amatur
Nichil	Nichil

qͥppe	quippe
s	s
ad	ad
edomãdũ	edomandum
carnaliũ	carnalium
desid̃ioꝝ	desideriorum
appetitũ	appetitum
ual&	ualet
quã	quam
u	u
un᷒qͥsq	unusquisque
hoc	hoc
q̃d	quod
uiuũ	uiuum
diligit	diligit
quale	quale
sit	sit
mortuũ	mortuum
penset	penset
Consid̃ata	Considerata
&enĩ	etenim
corruptione	corruptione
carnali	carnali
citi᷒	citius
cognoscit᷑	cognoscitur

qͥa	quia
illicite	illicite
caro	caro
cõcupiscit᷑	concupiscitur
tabes	tabes
desid̃at᷑	desideratur
Bene	Bene
gͦ	ergo
de	de
lux	lux
riosi	riosi
m̃te	mente
dr̃d	dicitur
dulcedo	dulcedo
illi᷒	illius
ũmis	uermis
;	;
qͥa	quia
is	is
qͥ	qui
in	in
desid̃io	desiderio
car	car
lis	lis
corruptionis	corruptionis

exestuat	exestuat
ad	ad
fetorẽ	fetorem
putredinis	putredinis
anhel	anhel
Hec	Hec
sic̃	sicut
in	in
hui᷒	huius
partis	partis
t̃cie	tercie
initio	initio
ꝓmisisse	promisisse
me	me
me	me
ni	ni
sub	sub
breuitate	breuitate
tͣnscurri	transcurri
ut	ut
ea	ea
que	que
in	in
hoc	hoc
oꝑe	opere

Isq	Isque
in	in
itinere	itinere
cum	cum
ꝓph̃am	prophetam
aGabum	aGabum
repperisset	repperisset
qͣnta	quanta
se	se
adu͛sitas	aduersitas
in	in
iherosolimis	iherosolimis
maneret	maneret
audiuit	audiuit
Scrip	Scrip
tum	tum
÷	est
qͥppe	quippe
q̃d	quod
idem	idem
aGabus	aGabus
zonam	zonam
pauli	pauli
suis	suis
pedib	pedibus

in	in
serens	serens
dixit	dixit
Virum	Virum
cui᷒	cuius
hec	hec
zona	zona
est	est
sic	sic
alligabunt	alligabunt
in	in
ihe	ihe
rusalem	rusalem
A	A
paulo	paulo
aut̃	autem
ꝓtinus	protinus
respondetur	respondetur
Ego	Ego
nõ	non
solum	solum
alligari	alligari
s	sed
etiam	etiam
mori	mori

in	in
ihrl̃m	ierusalem
paratus	paratus
sum	sum
ꝓ	pro
noĩe	nomine
ih̃u	iesu
Ne	Ne
q	que
enim	enim
ciosiorem	preciosiorem
fatio	fatio
aĩam	animam
meam	meam
qͣm	quam
me	me
ꝑceptione	perceptione
gͥ	igitur
reuelationis	reuelationis
iherosolimam	iherosolimam
ꝑgens	pergens
adũsa	aduersa
cognoscit	cognoscit
	et
tam̃	tamen

hec	hec
libent̃	libenter
appetit	appetit
Audit	Audit
que	que
timeat	timeat
s	sed
ad	ad
hec	hec
arden	arden
tior	tior
anhelat	anhelat
Moyses	Moyses
itaq	itaque
ad	ad
ꝓsꝑa	prospera
de	de
suo	suo
nil	nil
habet	habet
	quia
ci	preci
b	bus
renititur	renititur
ne	ne

sentis	presentis
potestatis	potestatis
gl̃am	gloriam
deo	deo
uoluit	uoluit
iubente	iubente
declinare	declinare
iste	iste
deo	deo
asꝑa	aspera
	et
dura	dura
disponente	disponente
se	se
studuit	studuit
ad	ad
grauiora	grauiora
parare	preparare
Preeun	Preeun
te	te
gͦ	ergo
utrorumq	utrorumque
ducũ	ducum
infracta	infracta
uirtute	uirtute

instituimur	instituimur
ut	ut
si	si
obedientie	obedientie
palmam	palmam
apprehend̃e	apprehendere
ueracit̃	ueraciter
nitim᷑	nitimur
ꝓsꝑis	prosperis
h᷒	huius
scl̃i	seculi
culu	culu
a	a
latronib	latronibus
uulñata	uulnerata
ꝑ	per
fidẽ	fidem
trinitat	trinitat
xxiiii	xxiiii
in	in
hoc	hoc
deẜto	deserto
reꝑatuR	reparatuR
Alius	Alius
ẜmo	sermo

eod̃	eodem
d	d
QUi	QUi
habitat	habitat
in	in
adiutorio	adiutorio
altissim	altissim
in	in
ꝓtectiõe	protectione
dei	dei
celi	celi
cõmorabitur	commorabitur
Inclinauit	Inclinauit
altissim᷒	altissimus
celos	celos
et	et
descẽ	descen
dit	dit
et	et
adeo	adeo
descẽdit	descendit
q̃d	quod
in	in
sil̃itudi	similitudi
nẽ	nem

hoĩum	hominum
factus	factus
ẽ	est
et	et
habitu	habitu
inuẽtus	inuentus
ut	ut
h̃o	homo
Adeo	Adeo
descẽdit	descendit
q̃d	quod
sub	sub
manu	manu
ẜui	serui
hũi	humi
liauit	liauit
se	se
baptizandũ	baptizandum
uñ	unde
et	et
baptista	baptista
cõ	con
tremuit	tremuit
cũ	cum
uid̃et	uideret

sub	sub
manib	manibus
suis	suis
inclin	inclin
ri	ri
caput	caput
trem̃dũ	tremendum
regib	regibus
et	et
potestatib	potestatibus
ad	ad
randũ	randum
Adeo	Adeo
hũiliauit	humiliauit
se	se
ut	ut
cũ	cum
ieiunass	ieiunass
et	et
esuriret	esuriret
ausus	ausus
ẽ	est
ad	ad
eũ	eum
acced̃e	accedere

tẽptato	temptato
ut	ut
eisdẽ	eisdem
iacul̃	iaculis
cofod̃et	cofoderet
quib	quibus
pͥmũ	primum
hoĩem	hominem
se	se
uiuũ	uiuum
et	et
uuln͛atũ	uulneratum
reliq̃rat	reliquerat
s	sed
uictus	uictus
ẽ	est
t	t
ptator	ptator
et	et
uicit	uicit
eũ	eum
altissim᷒	altissimus
S	Sed
quo	quo
adiu	adiu

torio	torio
usus	usus
ẽ	est
altissimus	altissimus
ut	ut
eũ	eum
uinc͛et	uinceret
ne	ne
usus	usus
adiutorio	adiutorio
potẽtie	potentie
sue	sue
Nequa	Nequa
Poss	Posset
enĩ	enim
statĩ	statim
ꝯterere	conterere
sathanã	sathanam
si	si
uellet	uellet
su	su
memoriam	memoriam
mĩe	misericordie
ignorat	ignorat
xlii	xlii

Ceperunt	Ceperunt
aũ	autem
aque	aque
minui	minui
p᷒	post
centũ	centum
quinqͣginta	quinquaginta
dies	dies
&	et
requieuit	requieuit
ar	ar
cha	cha
suꝑ	super
montes	montes
armenie	armenie
In	In
epl̃a	epistula
ad	ad
ysatium	ysatium
Seruata	Seruata
ũitate	ueritate
hystorie	hystorie
qͥd	quid
ẽ	est
aliud	aliud

q̃d	quod
diluuii	diluuii
tempore	tempore
gen᷒	genus
human᷒	humanus
extͣ	extra
archam	archam
moritur	moritur
ad	ad
uitã	uitam
uͦ	uero
in	in
archa	archa
seruatur	seruatur
nͥ	nisi
hoc	hoc
q̃d	quod
nc̃	nunc
aꝑte	aperte
cernimus	cernimus
quia	quia
in	in
fideles	fideles
quosq	quosque
extra	extra

eccl̃iam	ecclesiam
un	un
da	da
peccati	peccati
sui	sui
ꝑimit	perimit
&	et
fideles	fideles
suos	suos
in	in
fide	fide
&	et
caritate	caritate
sc̃e	sancte
eccl̃ie	ecclesie
unitas	unitas
qͣsi	quasi
ar	ar
che	che
conpago	conpago
custodit	custodit
Que	Que
uidelicet	uidelicet
ar	ar
cha	cha

&	et
mali	mali
ꝯueniunt	conueniunt
ꝑmixta	permixta
sitatefilioꝝ	sitatefiliorum
	quia
sic	sic
om̃s	omnes
ad	ad
f	f
ut	ut
tñ	tamen
om̃s	omnes
ꝑ	per
inmutatõem	inmutationem
u	u
tem	tem
spiritalis	spiritalis
gr̃e	gratie
culpis	culpis
exig	exig
ducat	ducat
Viam	Viam
itaq	itaque
sentis	presentis

syon	syon
ex	ex
alta	alta
in	in
forti	forti
tudine	tudine
uocem	uocem
tuam	tuam
qui	qui
euuangelyzas	euuangelyzas
hierusalem	hierusalem
ex	ex
alta	alta
noli	noli
timere	timere
dic	dic
ciui	ciui
tatib	tatibus
iude	iude
ecce	ecce
deus	deus
uester	uester
Ecce	Ecce
dies	dies
ueni	ueni

unt	unt
dicit	dicit
dominus	dominus
et	et
suscitabo	suscitabo
dauid	dauid
germen	germen
iustum	iustum
et	et
regnabit	regnabit
rex	rex
et	et
sapiens	sapiens
erit	erit
et	et
faciet	faciet
iuditium	iuditium
et	et
iustitiam	iustitiam
in	in
terra	terra
et	et
hec	hec
est	est
nomen	nomen

quod	quod
uocabunt	uocabunt
eum	eum
dominus	dominus
iustus	iustus
noster	noster
In	In
diebus	diebus
illis	illis
saluabitur	saluabitur
iuda	iuda
et	et
isra	isra
hel	hel
habitabit	habitabit
confidentes	confidentes
Et	Et
hoc	hoc
est	est
nomen	nomen
ymnus	ymnus
Conditor	Conditor
alme	alme
syderum	syderum
eterna	eterna

lux	lux
credenti	credenti
um	um
xpiste	xpiste
redemptor	redemptor
omnium	omnium
exaudi	exaudi
	pre
ces	ces
supplicum	supplicum
Qui	Qui
condolens	condolens
interitu	interitu
mortis	mortis
perire	perire
seculum	seculum
saluasti	saluasti
mundum	mundum
lan	lan
guidum	guidum
donans	donans
reis	reis
remedium	remedium
Vergente	Vergente
mundi	mundi

uespere	uespere
uti	uti
sponsus	sponsus
de	de
thalamo	thalamo
egressus	egressus
honestissi	honestissi
ma	ma
uirginis	uirginis
matris	matris
clausula	clausula
Cuius	Cuius
forti	forti
potentie	potentie
genu	genu
curuantur	curuantur
omnia	omnia
celestia	celestia
terrestria	terrestria
nutu	nutu
fatentur	fatentur
subdita	subdita
Ocasum	Ocasum
sol	sol
custodiens	custodiens

luna	luna
pallo	pallo
rem	rem
retinens	retinens
candor	candor
in	in
astris	astris
relucens	relucens
certos	certos
ob	ob
seruat	seruat
limites	limites
Te	Te
deprecamur	deprecamur
agye	agye
uen	uen
ture	ture
iudex	iudex
seculi	seculi
conserua	conserua
nos	nos
in	in
tempore	tempore
hostis	hostis
a	a

telo	telo
perfidi	perfidi
Laus	Laus
honor	honor
uirtus	uirtus
gloria	gloria
deo	deo
patri	patri
et	et
filio	filio
una	una
cum	cum
sancto	sancto
spiritu	spiritu
in	in
sempiterna	sempiterna
secula	secula
amen	amen
Horate	Horate
celi	celi
desu	desu
per	per
et	et
nubes	nubes
pluant	pluant

iustum	iustum
aperiatur	aperiatur
certa	certa
et	et
germinet	germinet
saluatorem	saluatorem
In	In
eug̃	euangelio
ã	antiphona
Ecce	Ecce
nomen	nomen
domini	domini
uenit	uenit
de	de
lon	lon
Incipit	Incipit
tercius	tercius
liber	liber
Fictilis	Fictilis
interea	interea
uasis	uasis
ꝯpage	conpage
soluta	soluta
carc̃e	carcere
corporeo	corporeo

cognatis	cognatis
reddit᷒	redditus
astͥs	astris
Ille	Ille
olĩ	olim
qui	qui
ꝓpter	propter
opẽ	opem
ꝯtͣ	contra
itala	itala
regna	regna
Petrũ	Petrum
legarat	legarat
adrianus	adrianus
ppͣ	papa
ꝑegit	peregit
extremos	extremos
in	in
pace	pace
dies	dies
m̃itiq	meritique
ꝓbati	probati
clerus	clerus
apl̃ica	apostolica
fecit	prefecit

sede	sede
leonem	leonem
cui	cui
si	si
in	in
sublimi	sublimi
ꝯstaret	constaret
adorsio	adorsio
rerũ	rerum
Ad	Ad
sacrũ	sacrum
fuerat	fuerat
facil̃	facilis
fortuna	fortuna
cacumen	cacumen
S	Sed
non	non
blanda	blanda
satis	satis
nͨ	nec
ad	ad
omnẽ	omnem
ꝓsꝑa	prospera
casũ	casum
Sic	Sic

in	in
mundanis	mundanis
absq	absque
õi	omni
turbine	turbine
reb	rebus
nͨ	nec
mera	mera
leticia	leticia
ẽ	est
nͨ	nec
leta	leta
oĩo	omnino
uoluptas	uoluptas
Pax	Pax
ubi	ubi
nl̃la	nulla
rata	rata
ẽ	est
ubi	ubi
gl̃ia	gloria
nl̃la	nulla
quieta	quieta
⁊	et
nl̃lus	nullus

secur᷒	securus
honos	honos
exꝑtus	expertus
in	in
alto	alto
hoc	hoc
leo	leo
ꝯscensu	conscensu
ẽ	est
qui	qui
tutior	tutior
ima	ima
tenebat	tenebat
Hunc	Hunc
in	in
equo	equo
cũ	cum
iã	iam
põpam	pompam
ducendo	ducendo
sed̃et	sederet
Appetiit	Appetiit
manuũ	manuum
uiolenta	uiolenta
iniectio	iniectio

tͣctũ	tractum
Nequit̃	Nequiter
⁊	et
sacra	sacra
de	de
maiestate	maiestate
reuulsũ	reuulsum
Quẽ	Quem
predefuncti	predefuncti
pape	pape
excecare	excecare
parentes	parentes
Excito	Excito
ꝯtra	contra
seducte	seducte
turbine	turbine
plebis	plebis
sumpsere	presumpsere
nͨ	nec
ex	ex
ocl̃is	oculis
ablata	ablata
luc̃na	lucerna
ẽ	est
sc̃issimi	sanctissimi

ꝯf̃	confratris
dignat᷒	dignatus
ẽ	est
multa	multa
miracl̃a	miracula
oꝑari	operari
ꝓlog᷒	prologus
CVm	CVm
uetustatis	uetustatis
in	in
cõmodo	commodo
nouer	nouer
cante	cante
res	res
fere	fere
sin	sin
gulas	gulas
obsoleri	obsoleri
cõ	con
tingat	tingat
cum	cum
nouem	nouem
leꝓsos	leprosos
curatione	curatione
po	po

titos	titos
nõ	non
parum	parum
reos	reos
intelle	intelle
xerimus	xerimus
quia	quia
d̃i	dei
gloriam	gloriam
ta	ta
cuerunt	cuerunt
cum	cum
decimo	decimo
reuer	reuer
tente	tente
dñm	dominum
glorificantes	glorificantes
suꝑ	super
his	his
que	que
audiuim᷒	audiuimus
⁊	et
uidim᷒	uidimus
que	que
a	a

dño	domino
facta	facta
mirabilia	mirabilia
fuerunt	fuerunt
in	in
occl̃is	occuis
ur̃is	uestris
poste	poste
D	D
comite	comite
nr̃o	nostro
Rich	Rich
rege	rege
anglie	anglie
uiro	uiro
uidel	uidel
nine	nine
nobilitatis	nobilitatis
noti	noti
cui	cui
in	in
egregia	egregia
feritate	feritate
sibi	sibi
contemporaneũ	contemporaneum

i	i
conparandũ	conparandum
orta	orta
sun	sun
mata	mata
⁊	et
infames	infames
cont	cont
inter	inter
homines	homines
huius	huius
Hac	Hac
de	de
causa	causa
quia	quia
de	de
r	r
cessione	cessione
⁊	et
assignatione	assignatione
uersas	uersas
ꝑgerent	pergerent
conse	conse
ꝑsonas	personas
Quidã	Quidam

enĩ	enim
a	a
bantur	bantur
ioh̃em	iohannem
iam	iam
d	d
ti	ti
regis	regis
fratrem	fratrem
regem	regem
si	si
uid̃is	uideris
nudũ	nudum
oꝑi	operi
eũ	eum
⁊	et
pauꝑẽ	pauperem
⁊	et
absq	absque
tecto	tecto
induc	induc
in	in
tab̃naculũ	tabernaculum
tuum	tuum
Tunc	Tunc

erũpet	erumpet
temporanea	temporanea
lux	lux
tua	tua
⁊	et
sanitates	sanitates
tue	tue
cito	cito
orient᷑	orientur
Hoc	Hoc
qͦq	quoque
q̃d	quod
scͥptum	scriptum
ẽ	est
in	in
Lxx	Lxx
misit	misit
de	de
bethel	bethel
sarasar	sarasar
⁊	et
ebeser	ebeser
rex	rex
nullus	nullus
nr̃oꝝ	nostrorum

potuit	potuit
exponere	exponere
Neq.	Neque
enĩ	enim
q̃d	quod
male	male
uersũ	uersum
ẽ	est
ex	ex
ebreo	ebreo
ulla	ulla
ratione	ratione
ex	ex
planari	planari
pot̃	potest
Quis	Quis
ẽ	est
enĩ	enim
iste	iste
sarasar	sarasar
⁊	et
ebeser	ebeser
rex	rex
aut	aut
cui᷒	cuius

ꝓuincie	prouincie
aut	aut
in	in
qua	qua
ul̃	ue
de	de
qua	qua
misit	misit
bethel	bethel
aut	aut
cui᷒	cuius
bethel	bethel
rex	rex
eẽ	esse
poterat	poterat
ebeser	ebeser
que	que
olim	olim
cũ	cum
iudea	iudea
fuerat	fuerat
destituta	destituta
⁊	et
eo	eo
tpr̃	tempore

nequaquã	nequaquam
uocabat᷑	uocabatur
bethel	bethel
id	id
ẽ	est
dom᷒	domus
dñi	domini
s	sed
betauen	betauen
.i.	idest
dom᷒	domus
ydoli	ydoli
Hoc	Hoc
qͦq	quoque
q̃d	quod
seqͥr	sequitur
ingressa	ingressa
ẽ	est
in	in
m̃	men
se	se
qͥnto	quinto
sc̃ificatio	sanctificatio
sic̃	sicut
fecerant	fecerant

iam	iam
ꝑ	per
multos	multos
annos	annos
sic	sic
conant᷑	conantur
ex	ex
ponere	ponere
sc̃ificationẽ	sanctificationem
ingressã	ingressam
uasa	uasa
tẽpli	templi
q̃	que
a	a
nabucodonosor	nabucodonosor
fu	fu
erant	erant
sublata	sublata
in	in
illo	illo
tpr̃	tempore
restituta	restituta
De	De
quinti	quinti
aut̃	autem

⁊	et
septimi	septimi
ieiunio	ieiunio
temptauer̃	temptauerunt
referre	referre
ad	ad
dies	dies
ebdomadis	ebdomadis
S	Sed
	quia
seqͥr	sequitur
decimi	decimi
ieiuni	ieiuni
um	um
cõpulsi	compulsi
s̃t	sunt
ad	ad
m̃ses	menses
referre	referre
⁊	et
q̃d	quod
sit	sit
ipse	ipse
quinti	quinti
⁊	et

septimi	septimi
decimũ	decimum
q	que
m̃sis	mensis
ieiuniũ	ieiunium
omnino	omnino
siluer̃	siluerunt
ut	ut
de	de
priore	priore
sim᷒	simus
explanatione	explanatione
ꝯtenti	contenti
⁊	et
ñ	non
indignem᷑	indignemur
ad	ad
falsos	falsos
commentantiũ	commentantium
conatus	conatus
qͥ	qui
de	de
int̃pre	interpre
tationis	tationis
errore	errore

uener̃	uenerunt
Et	Et
factũ	factum
ẽ	est
u͛bum	uerbum
dñi	domini
ad	ad
zachariã	zachariam
dicens	dicens
Hec	Hec
dic̃	dicit
dñs	dominus
exercituũ	exercituum
dicens	dicens
Iudiciũ	Iudicium
iustũ	iustum
iudicate	iudicate
⁊	et
miscdĩam	misericordiam
&	et
Sr̃	Super
cartã	cartam
caritatiᷤ	caritatis
Antequã	Antequam
abbatie	abbatie

cist̃cien.	cistercienses
flo	flo
rere	rere
inciperent	inciperent
domnus	domnus
ste	ste
phanus	phanus
abbas	abbas
et	et
fr̃s	fratres
sui	sui
ordina	ordina
uerunt	uerunt
ut	ut
nullo	nullo
mͦ	modo
abbatie	abbatie
in	in
a	a
licui᷒	licuius
antistitis	antistitis
diocesi	diocesi
fundarent᷑	fundarentur
anteꝙͣ	antequam
ip̃e	ipse

hoc	hoc
gͦ	ergo
dec͛to	decreto
dicti	predicti
fr̃s	fratres
mutue	mutue
pacis	pacis
futuꝝ	futurum
cauentes	precauentes
naufragiũ	naufragium
elucidauerunt	elucidauerunt
et	et
sta	sta
tuer̃	tuerunt
suisq	suisque
posteris	posteris
reliquer̃	reliquerunt
quo	quo
pacto	pacto
quoue	quoue
mͦ	modo
immo	immo
qua	qua
carita	carita
te	te

monachi	monachi
eoꝝ	eorum
ꝑ	per
abbatias	abbatias
in	in
diu͛	diuer
sis	sis
mundi	mundi
partib	partibus
corporib	corporibus
diui	diui
homiñ	hominum
sub	sub
regulari	regulari
disciplina	disciplina
or	or
dinauerit	dinauerit
nullã	nullam
terrene	terrene
cõmo	commo
ditatis	ditatis
seu	seu
reꝝ	rerum
tẽporaliũ	temporalium
exactio	exactio

nẽ	nem
imponimus	imponimus
Prodesse	Prodesse
enĩ	enim
ill̃	illis
õibq	omnibusque
sc̃e	sancte
eccl̃ie	ecclesie
filiis	filiis
cupientes	cupientes
nil	nil
quod	quod
eos	eos
grauet	grauet
nil	nil
q̃d	quod
eorũ	eorum
substantiã	substantiam
minuat	minuat
erga	erga
eos	eos
ag̃e	agere
disponim᷒	disponimus
ne	ne
dũ	dum

gr̃a	gratia
caritatis	caritatis
retinere	retinere
uolumus	uolumus
ut	ut
si	si
qnͦ	quando
a	a
sc̃o	sancto
ꝓposito	proposito
et	et
obseruan	obseruan
tia	tia
sc̃e	sancte
regl̃e	regule
declinare	declinare
q̃d	quod
absit	absit
tẽp	temp
tau͛ĩt	tauerint
ꝑ	per
nr̃am	nostram
sollicitudinẽ	sollicitudinem
ad	ad
rec	rec

IN	IN
domino	domino
confido	confido
quomodo	quomodo
anime	anime
mee	mee
transmigra	transmigra
in	in
mo	mo
sicut	sicut
passer	passer
Quoniam	Quoniam
ecce	ecce
peccatores	peccatores
inten	inten
arcum	arcum
parauerunt	parauerunt
sagittas	sagittas
su	su
retra	retra
ut	ut
sagittent	sagittent
in	in
obscuro	obscuro
re	re

Quoniam	Quoniam
que	que
ꝑfecisti	perfecisti
destruxeru	destruxeru
stus	stus
autem	autem
quid	quid
fecit	fecit
Dominus	Dominus
in	in
templo	templo
sancto	sancto
suo	suo
in	in
celo	celo
sedes	sedes
eius	eius
Oculi	Oculi
eius	eius
in	in
pauꝑem	pauperem
respiciunt	respiciunt
bre	bre
eius	eius
interrogãt	interrogant

filios	filios
homi	homi
Dominus	Dominus
interrogat	interrogat
iustum	iustum
et	et
qui	qui
autem	autem
diligit	diligit
iniquitate	iniquitate
animam	animam
suam	suam
Pluet	Pluet
suꝑ	super
peccatores	peccatores
laqueos	laqueos
i	i
eris	eris
dabo	dabo
tͥ	tibi
lic	licet
dimidiũ	dimidium
regni	regni
mei	mei
Qͤ	Que

c̃	cum
exiss	exisset
dix̃	dixit
matͥ	matri
sue	sue
Qͥd	Quid
petã	petam
et	et
illa	illa
dix̃	dixit
cap̃	caput
ioh̃is	iohannis
babtiste	babtiste
Cũq	Cumque
ĩtͦiss	introisset
statĩ	statim
c̃	cum
festi	festi
natiõe	natione
a	ad
Regẽ	Regem
petiũ	petiuit
dicẽs	dicens
Uolo	Uolo
ut	ut

ꝓtin᷒	protinus
des	des
mͥ	michi
ĩ	in
disco	disco
caput	caput
iohannis	iohannis
babtiste	babtiste
Et	Et
ꝯtͥstatu᷒	contristatuus
÷	est
Rex	Rex
ꝓpt̃	propter
i᷒iurãdũ	iusiurandum
⁊	et
ꝓpt̃	propter
simul	simul
re	re
cũbẽtes	cumbentes
noluit	noluit
eã	eam
ꝯtͥstare	contristare
S	Sed
misso	misso
spiculatore	spiculatore

sue	sue
Qͦ	Quo
audito	audito
diᷤscipl̃i	disscipuli
ei᷒	eius
uener̃	uenerunt
⁊	et
tul̃ũt	tulerunt
corp᷒	corpus
ei᷒	eius
⁊	et
posuer̃	posuerunt
illd̃	illd
ĩ	in
monum̃to	monumento
Et	Et
egͤss᷒	egressus
÷	est
ih̃s	iesus
⁊	et
discipl̃i	discipuli
ei᷒	eius
ĩ	in
castella	castella
cesaree	cesaree

philippi	philippi
&	et
ĩ	in
uia	uia
ĩt̃rogabat	interrogabat
discipl̃oᷤ	discipulos
suoᷤ	suos
dicẽs	dicens
eis	eis
Qͤm	Quem
me	me
dicũt	dicunt
hoĩnes	hominnes
eẽ	esse
Qͥ	Qui
respõd̃ũt	responderunt
illi	illi
dicẽtes	dicentes
ioh̃m	iohannem
babtistã	babtistam
Alii	Alii
heliã	heliam
Alii	Alii
uͦ	uero
qͣsi	quasi

unũ	unum
de	de
ꝓph̃is	prophetis
Tc̃	Tunc
dic̃	dicit
ill̃	illis
Vos	Vos
uͦ	uero
qͤm	quem
me	me
dicitiᷤ	dicitis
eẽ	esse
Respõdẽs	Respondens
Petr᷒	Petrus
ait	ait
ei	ei
Tu	Tu
es	es
xp̃s	Christus
Et	Et
ꝯminat᷒	comminatus
÷	est
eis	eis
ne	ne
cͥ	cui

dic̃ẽt	dicerent
d̃	de
illo	illo
&	et
ĩt̃rogabãt	interrogabant
eũ	eum
dicẽtes	dicentes
Qͥd	Quid
gͦ	ergo
dicũt	dicunt
pharisei	pharisei
⁊	et
scͥbe	scribe
qͥa	quia
heliã	heliam
oꝑt	oportet
pͥmũ	primum
venire	venire
Qͥ	Qui
Respõdẽs	Respondens
ait	ait
ill̃	illis
Helias	Helias
c̃	cum
ueñit	uenerit

q̃c̃q	quecumque
uoluer̃	uoluerunt
sic̃	sicut
scͥptũ	scriptum
÷	est
de	de
eo	eo
Explicit	Explicit
h̃	hec
scͥpsit	scripsit
B	B
armari᷒	armarius
ãno	anno
MͦCCͦXIIIͦ	MoCCoXIIIo
int̃dũ	interdum
⁊	et
forte	forte
ꝗa	quia
sanitas	sanitas
ul̃	ue
infirmitas	infirmitas
cõ	cor
poris	poris
consistit	consistit
in	in

quattuor	quattuor
⁊	et
aĩe	anime
in	in
tͥb	tribus
ut	ut
predixim᷒	prediximus
Iñ	Inde
ẽ	est
quod	quod
stola	stola
corpõis	corporis
dr̃d	dicitur
fut᷑a	futura
in	in
quattuor	quattuor
ꝓpͥetatib	proprietatibus
corpõis	corporis
gl̃ificati	glorificati
⁊	et
sto	sto
la	la
aĩe	anime
pͥncipalit̃	principaliter
in	in

tͥb	tribus
Erũt	Erunt
enĩ	enim
quattuor	quattuor
principales	principales
dotes	dotes
corpõis	corporis
gl̃ificati	glorificati
s.	scilicet
sub	sub
tilitas	tilitas
⁊	et
agilitas	agilitas
splendor	splendor
⁊	et
impassibilitas	impassibilitas
iux̃	iuxta
illd̃	illd
ĩ	in
libro	libro
sap̃ie	sapentie
fulgebũt	fulgebunt
iusti	iusti
sic̃	sicut
sol	sol

ĩ	in
regͦ	regno
pa.	patris
m̃i	mei
⁊	et
tãꝙͣ	tanquam
scin.	scintille
ĩ	in
a.	arundineto
di.	discurrent
fulgeb̃t	fulgebunt
ꝑ	per
splẽ	splen
dorẽ	dorem
sic̃	sicut
sol	sol
ꝑ	per
ĩmu	immu
tabilitatem	tabilitatem
ad	ad
ueritatẽ	ueritatem
siue	siue
ĩpassibili	impassibili
tatẽ	tatem
	quia

sol	sol
ĩ	in
sua	sua
nat᷑a	natura
ẽ	est
ĩmutabilis	immutabilis
⁊	et
ĩpassibil̃	impassibilis
taꝙͣ	taquam
scĩtille	scintille
ꝑ	per
subtilitatẽ	subtilitatem
discũrẽt	discurrent
ꝑ	per
agilita	agilita
tẽ	tem
Has	Has
qͣttuoͬ	quattuor
ꝓͥetates	proprietates
gl̃ificati	glorificati
coͬꝑis	corporis
ĩ	in
argu	argu
m̃tatiõe	mentatione
fut᷑e	future

gl̃ificatiõis	glorificationis
⁊̃	etiam
ĩ	in
caͬne	carne
moͬtali	mortali
xᷤ	Christus
ost̃ndit	ostendit
claritatẽ	claritatem
qñ	quando
se	se
tͣnsfiguraũ	transfigurauit
ĩ	in
mõ	mon
te	te
⁊	et
resplẽunt	resplenunt
facies	facies
ei᷒	eius
sic̃	sicut
sol	sol
Subtilitatẽ	Subtilitatem
qñ	quando
clauso	clauso
sigͣcl̃o	signaculo
uirginali	uirginali

tãꝙͣ	tanquam
spõsus	sponsus
ꝓces	proces
sit	sit
de	de
tha.	thalamo
suo	suo
Agilitatẽ	Agilitatem
siue	siue
leuitatẽ	leuitatem
qñ	quando
aliã	aliam
litt̃am	litteram
ubi	ubi
nos	nos
habem᷒	habemus
quis	quis
mundũ	mundum
de	de
inmundo	inmundo
conceptũ	conceptum
infans	infans
unius	unius
diei	diei
ẽ	est

sine	sine
pecc̃o	peccato
⁊	et
p	p
m᷒	mus
natura	natura
filii	filii
ire	ire
ab	ab
hac	hac
tñ	tamen
qui	qui
pͥuilegiati	priuilegiati
fuer̃	fuerunt
mũdati	mundati
añ	ante
nat	nat
in	in
ut̃is	uteris
matrũ	matrum
ut	ut
Ier	Ier
emias	emias
⁊	et
Io	Io

annes	annes
qui	qui
ex	ex
ut̃o	utero
matris	matris
Quoꝝ	Quorum
utͥ	utrique
oc	oc
Pͥus	Prius
quã	quam
te	te
formarẽ	formarem
in	in
ut̃o	utero
nou	nou
exires	exires
d̃	de
ũntre	uentre
sc̃ificaui	sanctificaui
te	te
quod	quod
⁊̃	etiam
tendũt	tendunt
de	de
iacob	iacob

⁊	et
b̃ata	beata
uͥgine	uirgine
q	q
habeat᷑	habeatur
exssum	expressum
Veniale	Veniale
pecca	pecca
ad	ad
illicita	illicita
citra	citra
consensũ	consensum
ratõis	rationis
eẽ	esse
nõ	non
possumus	possumus
ꝗa	quia
semꝑ	semper
Iebuse	Iebuse
in	in
t̃ra	terra
nr̃a	nostra
que	que
nob̃	nobis
spinas	spinas

⁊	et
tͥbu	tribu
nit	nit
g͛minare	germinare
d̃	de
hoc	hoc
ait	ait
b̃atus	beatus
io	io
annes	annes
Si	Si
dix̃imus	dixerimus
quod	quod
peccatũ	peccatum
ñ	non
h̃em	habem
se	se
ducim᷒	ducimus
⁊	et
ũitas	ueritas
in	in
nob̃	nobis
ñ	non
ẽ	est
Mor	Mor

In	In
epistolis	epistolis
beati	beati
pauli	pauli
apostoli	apostoli
PRIMUM	PRIMUM
QUERITUR	QUERITUR
quare	quare
post	post
eugl̃ia	euangelia
que	que
supplementũ	supplementum
legis	legis
sunt	sunt
⁊	et
in	in
quib᷒	quibus
nobis	nobis
exem	exem
pla	pla
⁊	et
cepta	precepta
uiuendi	uiuendi
plenissime	plenissime
digesta	digesta

sentia	presentia
⁊	et
mi	mi
encia	encia
resequaret	resequaret
uicia	uicia
⁊	et
ut	ut
post	post
futuras	futuras
excluder&	excluderet
questiones	questiones
exemplo	exemplo
ꝓphetarũ	prophetarum
qͥ	qui
post	post
editã	editam
legẽ	legem
mo	mo
ysi	ysi
in	in
qua	qua
õia	omnia
dei	dei
mandata	mandata

legebant᷑	legebantur
nichilomin᷒	nichilominus
de	de
doctrina	doctrina
sua	sua
rediuiua	rediuiua
semꝑ	semper
ppl̃i	populi
conpressere	conpressere
peccata	peccata
tͣnsmigrationẽ	transmigrationem
ierl̃m	ierusalem
in	in
mense	mense
qͥnto	quinto
r̃	responsorium
Isti	Isti
sunt	sunt
dies	dies
quos	quos
obser	obser
uare	uare
debetis	debetis
temꝑibus	temporibus
suis	suis

qͣrtadecima	quartadecima
die	die
ad	ad
uesꝑm	uesperum
pascha	pascha
dñi	domini
ẽ	est
̃	etiam
ĩ	in
qͥn	quin
tadecima	tadecima
sollempnitatẽ	sollempnitatem
celebrabitis	celebrabitis
altissimo	altissimo
dño	domino
ũ	uersus
Loquutus	Loquutus
ẽ	est
dñs	dominus
ad	ad
moysen	moysen
dicens	dicens
loquere	loquere
filiis	filiis
isr̃l	israhel

	et
dices	dices
ad	ad
eos	eos
Qͣrta	Quarta
l̃	lectio
scd̃a	secunda
Et	Et
fc̃m	factum
ẽ	est
ũbum	uerbum
domini	domini
ad	ad
me	me
dicens	dicens
Priusꝙͣ	Priusquam
te	te
formarem	formarem
in	in
utero	utero
noui	noui
te	te
	et
anteꝙͣ	antequam
exires	exires

de	de
uulua	uulua
sanctifica	sanctifica
ui	ui
te	te
	et
ꝓph̃am	prophetam
in	in
gentib	gentibus
dedi	dedi
te	te
Et	Et
dixi	dixi
a.	alleluia
a.	alleluia
a.	alleluia
dñe	domine
deus	deus
Ecce	Ecce
nescio	nescio
loqui	loqui
	quia
puer	puer
ego	ego
sum	sum

r̃	responsorium
Multiplicati	Multiplicati
sunt	sunt
qui	qui
tͥbulant	tribulant
me	me
	et
dicunt	dicunt
ñ	non
ẽ	est
salus	salus
ip̃i	ipsi
in	in
deo	deo
er̃	erunt
Exurge	Exurge
dñe	domine
saluuᷤ	saluus
me	me
fac	fac
deus	deus
m̃	me
uᷤ	us
Qui	Qui
tͥbulant	tribulant

me	me
exultabunt	exultabunt
si	si
mot᷒	motus
fuero	fuero
ego	ego
aut̃	autem
ĩ	in
mĩa	misericordia
tua	tua
sꝑaui	speraui
Et	Et
dix̃	dixit
dominus	dominus
ad	ad
me	me
Noli	Noli
dic̃e	dicere
	quia
puer	puer
sũ	sum
l̃	lectio
IIIͣ	IIIa
Exurge	Exurge
qm̃	quoniam

ad	ad
õia	omnia
que	que
mittam	mittam
te	te
ibis	ibis
	et
uniũsa	uniuersa
q̃cumq	quecumque
manda	manda
uero	uero
tͥ	tibi
loqueris	loqueris
Ne	Ne
timeas	timeas
a	a
facie	facie
eoꝝ	eorum
	quia
tecum	tecum
ego	ego
sum	sum
ut	ut
eruam	eruam
te	te

dicit	dicit
dic̃	dicit
dominus	dominus
Et	Et
misit	misit
dominus	dominus
manũ	manum
suam	suam
	et
tetigit	tetigit
os	os
meum	meum
r̃	responsorium
Qui	Qui
custodiebant	custodiebant
aĩam	animam
meam	meam
ꝯsiliũ	consilium
fecer̃t	fecerunt
ĩ	in
unum	unum
dicentes	dicentes
D̃s	Deus
dereliqͥt	dereliquit
eum	eum

ꝑseqͥmini	persequimini
	et
ꝯhendite	comprehendite
eum	eum
	quia
ñ	non
ẽ	est
qͥ	qui
liberet	liberet
eum	eum
deus	deus
m̃s	meus
ne	ne
elonges	elonges
a	a
me	me
deus	deus
m̃s	meus
ĩ	in
adiutoriũ	adiutorium
meum	meum
ĩten	inten
de	de
ũ	uersus
Omnes	Omnes

inimici	inimici
mei	mei
adũsum	aduersum
me	me
dicentes	dicentes
D̃s	Deus
l̃	lectio
iiiiͣ	iiiia
Et	Et
dix̃	dixit
dominus	dominus
ad	ad
me	me
Ecce	Ecce
dedi	dedi
ũba	uerba
mea	mea
in	in
ore	ore
tuo	tuo
ecce	ecce
constitui	constitui
te	te
hodie	hodie
suꝑ	super

ei᷒	eius
nocte	nocte
et	et
secessit	secessit
in	in
egiptũ	egiptum
Et	Et
erat	erat
ibi	ibi
usq	usque
ad	ad
obitum	obitum
herodis	herodis
ut	ut
adimpleret᷑	adimpleretur
q̃d	quod
dictũ	dictum
ẽ	est
a	a
dño	domino
ꝑ	per
ꝓph̃am	prophetam
dicentẽ	dicentem
Ex	Ex
egipto	egipto

uocaui	uocaui
filiũ	filium
meum	meum
Tunc	Tunc
he	he
rodes	rodes
uidens	uidens
qm̃	quoniam
illusus	illusus
eẽt	esset
a	a
magis	magis
iratus	iratus
est	est
ualde	ualde
Et	Et
mittens	mittens
occidit	occidit
om̃s	omnes
pueros	pueros
qͥ	qui
erant	erant
in	in
bethleem	bethleem
⁊	et

in	in
om̃ib	omnibus
finib	finibus
ei᷒	eius
ab	ab
imatu	imatu
⁊	et
infra	infra
scd̃m	secundum
tempus	tempus
q̃d	quod
exquisierat	exquisierat
a	a
magis	magis
Tunc	Tunc
ad	ad
impletum	impletum
ẽ	est
quod	quod
dictum	dictum
ẽ	est
ꝑ	per
ieremiam	ieremiam
ꝓph̃am	prophetam
dicentem	dicentem

Vox	Vox
in	in
rama	rama
audita	audita
ẽ	est
ploratus	ploratus
⁊	et
ulu	ulu
latus	latus
multus	multus
rachel	rachel
plorans	plorans
filios	filios
suos	suos
Et	Et
noluit	noluit
consolari	consolari
quia	quia
non	non
sunt	sunt
.	.
coll̃	collecta
Deus	Deus
cuius	cuius
hodierna	hodierna

In	In
l̃	laudibus
a	antiphona
Herodes	Herodes
iratus	iratus
occidit	occidit
mul	mul
tos	tos
pueros	pueros
in	in
bethleem	bethleem
iude	iude
ciuitate	ciuitate
dauid	dauid
cap̃	capitulum
Uidi	Uidi
supͣ	supra
montẽ	montem
syon	syon
agnum	agnum
stantẽ	stantem
et	et
cũ	cum
eo	eo
cen	cen

tum	tum
quadraginta	quadraginta
qͣtuor	quatuor
milia	milia
habentes	habentes
no	no
men	men
eius	eius
et	et
nom̃	nomen
patͥs	patris
eius	eius
scriptũ	scriptum
in	in
frontib	frontibus
suis	suis
r̃	responsorium
Exultent	Exultent
iusti	iusti
ũ	uersus
Iusti	Iusti
in	in
ꝑpetuum	perpetuum
Ad	Ad
bñ	benedicite

semꝑ	semper
uident	uident
faciem	faciem
patris	patris
Ad	Ad
iiiͣ	iiia
a	antiphona
Vox	Vox
in	in
rama	rama
au	au
dita	dita
ẽ	est
plorat᷒	ploratus
⁊	et
ululat᷒	ululatus
rachel	rachel
plorans	plorans
filios	filios
suos	suos
cap	cap
*	*
⁊	et
coll	coll
*	*

sicut	sicut
in	in
l	l
*	*
Ad	Ad
viͣ	via
a	antiphona
Sub	Sub
t	t
h	h
rono	rono
d̃i	dei
sc̃i	sancti
clamabant	clamabant
uindica	uindica
sanguinẽ	sanguinem
nr̃m	nostrum
d̃s	deus
nr̃	noster
capitulum	capitulum
Hii	Hii
sunt	sunt
qui	qui
cũ	cum
mulierib	mulieribus

ñ	non
sunt	sunt
coinquinati	coinquinati
uirgines	uirgines
enĩ	enim
sunt	sunt
hi	hi
secunt᷑	secuntur
agnũ	agnum
qͦcũq	quocunque
ierit	ierit
uo	uo
ĩ	in
feudum	feudum
ñ	non
succedat	succedat
nisi	nisi
prius	prius
d	d
domino	domino
sat̃fec̃it	satisfecerit
p̃ri	parique
modo	modo
ꝓ	pro
õib.	omnibus

i	i
domesticis	domesticis
suis	suis
hoc	hoc
faciat	faciat
Illud	Illud
quo	quoque
cipimus	precipimus
ut	ut
si	si
uassallus	uassallus
de	de
f	f
eudo	eudo
suo	suo
alium	alium
uassallũ	uassallum
h̃ũit	habuerit
et	et
ua	ua
ssalus	ssalus
uassalli	uassalli
dñm	dominum
dñi	domini
sui	sui

offẽd̃it	offenderit
nisi	nisi
ꝓ	pro
ẜuitõ	seruitio
alt̃ius	alterius
domini	domini
sui	sui
h̃	hoc
fec̃it	fecerit
q̃m	quem
sñ	sine
fraude	fraude
aña	antea
h̃ũit	habuerit
feudo	feudo
suo	suo
p	p
priuetur	priuetur
⁊	et
ad	ad
dñm	dominum
suũ	suum
a	a
quo	quo
ip̃e	ipse

maiorẽ	maiorem
dominũ	dominum
offendit	offendit
requisierit	requisierit
ut	ut
sa	sa
tis	tis
faciat	faciat
suum	suum
feudũ	feudum
amittat	amittat
t̃e	pretere
a	a
si	si
de	de
feudo	feudo
int̃	inter
duos	duos
uassallos	uassallos
sit	sit
ꝯ	con
troũsia	trouersia
domini	domini
sit	sit
ꝯgnitõ	cognitio

⁊	et
per	per
eum	eum
ꝯ	con
troũsia	trouersia
t̃minetur	terminetur
Si	Si
uõ	uero
ĩt̃	inter
dñm	dominum
et	et
uassallũ	uassallum
lis	lis
oriat᷑	oriatur
ꝑ	per
pares	pares
curie	curie
a	a
d	d
domĩo	domino
s̃o	suo
debito	debito
fidelitatis	fidelitatis
ꝯiurai	coniurai
tos	tos

t̃minetur	terminetur
Illud	Illud
quo	quoque
s̃cimuᷤ	sancimus
ut	ut
in	in
omni	omni
sac̃m̃to	sacramento
fidelitatis	fidelitatis
nom	nom
inatim	inatim
inmperator	inmperator
excipiatur	excipiatur
Explicit	Explicit
liber	liber
autenticorum	autenticorum
Explicit	Explicit
lib̃	liber
autenticorum	autenticorum
videbr̃	videbitur
siñ	sine
fastidio	fastidio
amabr̃	amabitur
siñ	sine
fatigatõe	fatigatione

laudabr̃	laudabitur
hoc	hoc
mun᷒	munus
cete	cete
rum	rum
qui	qui
futuri	futuri
sunt	sunt
ꝓ	pro
m̃itis	meritis
	pre
miorum	miorum
⁊	et
grado	grado
bonorũ	bonorum
atq	atque
gl̃i	glori
arum	arum
quis	quis
est	est
ydo᷒	ydoneus
cogitare	cogitare
qͣnto	quanto
mag̃	magis
dic̃e	dicere

	quia
tm̃	tamen
fut᷑um	futurum
sint	sint
ñ	non
ẽ	est
ã	am
bigend̃	bigendum
atq	atque
ita	ita
⁊̃	etiam
bt̃a	beata
illa	illa
ciuitas	ciuitas
magnum	magnum
in	in
se	se
donum	donum
uidebit	uidebit
q̃d	quod
nulli	nulli
superiori	superiori
nullus	nullus
inf̃ior	inferior
inuidebit	inuidebit

sic̃	sicut
ñ	non
ĩuidẽt	inuident
archãgl̃is	archangelis
ãgl̃i	angeli
cet̃i	ceteri
Tam	Tam
nollet	nollet
eẽ	esse
un᷒ꝗsq	unusquisque
q̃d	quod
ñ	non
accepit	accepit
qͣmuis	quamuis
sit	sit
pacatissi	pacatissi
mo	mo
uinculo	uinculo
cõcordie	concordie
ei	ei
qui	qui
accep̃	accepit
obstrictus	obstrictus
qͣm	quam
nec	nec

ĩ	in
corꝑe	corpore
uult	uult
o	o
cul	cul
i	i
u	u
s	s
eẽ	esse
qui	qui
ẽ	est
digitus	digitus
cum	cum
me	mem
brum	brum
utr̃q	utrumque
contineat	contineat
toci	tocius
partis	partis
paccata	paccata
compago	compago
sic	sic
itaq	itaque
habe	habe
bit	bit

donũ	donum
ali	alius
alio	alio
min	minus
ut	ut
hoc	hoc
qͦ	quoque
donũ	donum
h̃at	habeat
ne	ne
ul̃it	uelit
amplius	amplius
vicia	vicia
per	per
sapientie	sapientie
doctͥna	doctrina
alit̃	aliter
ꝑ	per
insipiẽtis	insipientis
pessimam	pessimam
uitã	uitam
ita	ita
⁊	et
obliuiones	obliuiones
maloꝝ	malorum

obliuiõe	obliuionem
quã	quam
post̃iore	posteriore
loco	loco
posui	posui
nõ	non
erunt	erunt
memores	memores
sc̃i	sancti
preteritorum	preteritorum
maloꝝ	malorum
Carebũt	Carebunt
eĩ	enim
om̃ib.	omnibus
ita	ita
ut	ut
penit	penitus
deleatur	deleatur
eorum	eorum
sensibus	sensibus
Et	Et
tm̃	tamen
potẽtia	potentia
scĩe	scientie
q̃	que

m̃gñ	magna
ĩ	in
eis	eis
erit	erit
ñ	non
solũ	solum
sua	sua
t̃ita	preterita
s	sed
⁊̃	etiam
dãpñtoꝝ	dampnatorum
eos	eos
sẽpit̃ñ	sempiterna
mi	mi
ẜia	seria
ñ	non
lateb̃	latebit
ĩuocabim	inuocabimus
⁊	et
uidebim᷒	uidebimus
⁊	et
am̃bim᷒	amabimus
am̃bim᷒	amabimus
⁊	et
laudabim᷒	laudabimus

Ecce	Ecce
ꝙ	quod
er̃	erit
ĩ	in
fĩe	fine
sũ	sum
fine	fine
Explicit	Explicit
Hũc	Hunc
libꝝ	librum
fec̃	fecit
scͥbi	scribi
dñs	dominus
B	B
de	de
castãeto	castaneto
d̃i	dei
gr̃a	gratia
ep̃s	episcopus
albieñ	albiensis
anno	anno
dñi	domini
mͦ	mo
cccͦ	ccco
organici	organici

in	in
eodẽ	eodem
instãti	instanti
in	in
quo	quo
desunt	desunt
eẽ	esse
talis	talis
ꝑs	pars
desinit	desinit
ibi	ibi
esse	esse
aĩa	anima
nec	nec
sequit᷑	sequitur
p̃p	propter
hoc	hoc
q̃d	quod
in	in
e	e
dem	dem
instãti	instanti
ibi	ibi
sit	sit
	et

nõ	non
sit	sit
	quia
nec	nec
ĩ	in
imo	imo
ĩstãti	instanti
pes	pes
uel	uel
manus	manus
est	est
ꝑs	pars
ul̃	ue
nõ	non
ꝑs	pars
ip̃ius	ipsius
corꝑis	corporis
utrum	utrum
ãima	anima
sit	sit
simplicior	simplicior
om̃ib	omnibus
aliis	aliis
formis	formis
SEcundo	SEcundo

querit᷑	queritur
utrum	utrum
aĩa	anima
sit	sit
simplicõr	simplicior
om̃ib	omnibus
aliis	aliis
formis	formis
	et
videt᷑	videtur
q̃d	quod
nõ	non
	quia
forma	forma
que	que
est	est
	et
plurib	pluribus
modis	modis
cõpoĩta	composita
qͣm	quam
alie	alie
est	est
ꝯ	com
positõr	positior

i	i
illis	illis
s	sed
aĩa	anima
hũana	humana
cõpoĩta	composita
est	est
ex	ex
eẽ	esse
	et
eẽncia	essencia
forme	forme
aut̃em	autemem
q̃	que
educit᷑	educitur
de	de
potẽcia	potencia
mat͛ie	materie
ñ	non
sũt	sunt
ex	ex
eẽ	esse
	et
eẽnͣ	essencia
ꝯpoĩte	composite

cũ	cum
eis	eis
nõ	non
ꝯpetat	competat
eẽ	esse
gͦ	ergo
aĩa	anima
est	est
cõpoĩcõr	composicior
eis	eis
Pͣ	Praeterea
eẽ	esse
unũ	unum
cõpoĩci᷒	composicius
alio	alio
dicit	dicit
qdd	qdd
qͦsdam	quosdam
gͣdus	gradus
s	sed
nulli	nulli
forͤ	forme
sb̃ali	substantiali
cõpetit	competit
h̃re	habere

gradus	gradus
ẜm	secundum
eẽmͣ	essemcia
cũ	cum
quelib	quelibet
talis	talis
simplici	simplici
	et
ĩua	inua
riabl̃i	riabili
eẽnͣ	essencia
cõsistat	consistat
nec	nec
ẜm	secundum
eẽ	esse
q̃d	quod
h̃t	habet
in	in
sb̃o	subiecto
cũ	cum
sb̃m	subiectum
forme	forme
sb̃alis	substantialis
sit	sit
ip̃m	ipsum

ind̃iduatõ	indiuiduatio
sine	sine
mͣ	materia
uel	uel
corꝑe	corpore
nõ	non
tingit	tingit
ꝯͣriũ	contrarium
est	est
aug̃	augustinus
VI	VI
de	de
tͥni.	trinitate
caͦ	capitulo
VI	VI
uͥ	ubi
dicit	dicit
q̃d	quod
cre	cre
atura	atura
sp̃ualis	spiritualis
sic̃	sicut
est	est
aĩa	anima
in	in

cõ	com
r	r
ꝑatõe	paratione
quidẽ	quidem
cor	cor
ꝑis	poris
simplicõr	simplicior
ẽ	est
licet	licet
ĩ	in
cõꝑatõe	comparatione
dei	dei
sit	sit
multiplex	multiplex
	et
	quia
quel	quelibet
alia	alia
forma	forma
potest	potest
dici	dici
corꝑalis	corporalis
cũ	cum
mo	mo
le	le

corꝑis	corporis
diffundat᷑	diffundatur
Id̃o	Ideo
sequit᷑	sequitur
q̃d	quod
aĩa	anima
aliis	aliis
for	for
mis	mis
sit	sit
simplicõr	simplicior
R̃nsio	Responsio
dd̃q̃d	dandaquod
tria	tria
sũt	sunt
illa	illa
que	que
ad	ad
simplicitate	simplicitate
requirũt᷑	requiruntur
pͥmũ	primum
̃	est
ĩd̃isibl̃ita	indiuisibilita
qua	qua
·H·	enim

ꝓbat᷑	probatur
eũ	eum
qͥ	qui
tͣbẽ	trabem
gestat	gestat
ĩ	in
ocl̃o	oculo
suo	suo
ñ	non
p᷒se	posse
fes	fes
educ̃	educer
de	de
ocl̃o	oculo
fr̃is	fratris
sui	sui
It̃	Item
d̃d	dauid
pcc̃ori	peccatori
ã	autem
dixͭ	dixit
de᷒	deus
qr̃	quare
tu	tu
enar.	enarras

i᷒ticias	iusticias
et	et
assũis	assumis
test̃ͫ	testamentum
m.	meum
ꝑ	per
os	os
tuũ	tuum
Et	Et
ẜ	secundum
gg̃ͫ	gregorium
c᷒	cuius
uita	uita
despic᷑	despiciatur
ꝯ	con
re	re
stat	stat
ut	ut
dicatõ	predicatio
ꝯdẽpnet᷑	condempnetur
hĩc	hinc
ẽ	est
eĩ	enim
ꝙ	quod
ysaias	ysaias

a	a
dño	domino
ad	ad
dicand̃	predicandum
mittend᷒	mittendus
pͥ᷒	prius
ab	ab
tate	tate
mũda᷑	mundatur
et	et
os	os
e᷒	eius
calcl̃o	calculo
tãgi᷑	tangitur
qͥ	qui
forcipe	forcipe
tolli᷑	tollitur
de	de
altari	altari
pri᷒	prius
gͥ	igitur
deb	deb
sac̃dotes	sacerdotes
errata	errata
sua	sua

corrig̃e	corrigere
	et
p᷒moͫ	postmodum
ad	ad
aliena	aliena
diluenda	diluenda
festĩar	festinar
Nã	Nam
	et
gall᷒	gallus
pͥ᷒	prius
se	se
ipͫ	ipsum
alaꝝ	alarum
ũb̃e	uerbere
corripit	corripit
	et
deiñ	deinde
ad	ad
horas	horas
cinendas	precinendas
cedit	cedit
sac̃dotes	sacerdotes
	et
·H·	enim

pler̃	plerumque
exemͦ	exemplo
sue	sue
passiõis	passionis
accendũt	accendunt
qͦs	quos
s̃uit	seruit
doctͥne	doctrine
diuti᷒	diutius
ꝯfͬmare	confirmare
ñ	non
p᷒s̃t	possunt
et	et
uita	uita
disciplinis	disciplinis
ñ	non
erudita	erudita
exẽp	exemp
religiõis	religionis
de	de
se	se
pr̃are	prestare
nescͭ	nescit
q̃	que
ĩ	in

nl̃lus	nullus
ur̃m	uestrum
arma	arma
l̃	uel
gla	gla
ad	ad
feriend̃	feriendum
ferat	ferat
nͥ	nisi
forte	forte
tpr̃	tempore
guerre	guerre
l̃	uel
ex	ex
ꝓbabl̃i	probabili
c̃a	causa
timor	timor
nl̃l᷒	nullus
comã	comam
nutͥat	nutriat
ne	neque
barbã	barbam
et	et
un᷒qͥs	unusquisque
coronã	coronam

.i.	idest
gulositatibus	gulositatibus
litib	litibus
scurrilitatib᷒	scurrilitatibus
ꝑcussiõib᷒	percussionibus
et	et
blasfemiis	blasfemiis
u	u
null᷒	nullus
spͨtacl̃is	spectaculis
aliqͥb	aliquibus
q̃	que
aut	aut
ĩ	in
nuptiis	nuptiis
aut	aut
ĩ	in
cenis	cenis
fũit	fuerit
exh	exh
ĩtersit	intersit
s	sed
põpas	pompas
scl̃i	seculi
	et

ꝯuiuia	conuiuia
nota	nota
puca	publica
fugiat	fugiat
pͥuata	priuata
uͦ	uero
ñ	non
pudica	pudica
s	sed
⁊	et
sobria	sobria
colat	colat
Un᷒qͥs	Unusquisque
ur̃m	uestrum
dolos	dolos
	et
ꝯiuratões	coniurationes
c	c
odiũ	odium
eml̃atões	emulationes
obtͤctatões	obtrectationes
at	atque
ĩuidiã	inuidiam
effugiat	effugiat
ñ	non

uagis	uagis
oc	oc
effͤnata	effrenata
lĩgua	lingua
aut	aut
petulãti	petulanti
fluidoq	fluidoque
ĩ	in
gestu	gestu
ĩcedat	incedat
s	sed
pu	pu
ac	ac
ueꝯdiã	uecondiam
mẽtis	mentis
sĩplici	simplici
h̃itu	habitu
ĩcessuq	incessuque
ost̃ndat	ostendat
obscenitatẽ	obscenitatem
boꝝ	borum
	et
mẽbroꝝ	membrorum
sic̃	sicut
	et

operũ	operum
pẽit᷒	penitus
execret᷑	execretur
seniorib	senioribus
debit	debit
at	at
ob̃iam	obedientiam
n	neque
ullo	ullo
iactãcie	iactancie
studio	studio
se	se
ipͫ	ipsum
attollat	attollat
bonis	bonis
mo	mo
studeat	studeat
	et
ab	ab
õib	omnibus
illicitis	illicitis
cor	cor
ac	ac
lĩguã	linguam
	et

corp᷒	corpus
adeo	adeo
t̃re	terre
ꝯs	cons
õis	omnis
·H·	enim
iactãcia	iactancia
at	atque
ĩmod̃atõ	immoderatio
a	a
bõis	bonis
÷	est
morib	moribus
aliena	aliena
null᷒	nullus
ꝑ	per
q̃d	quod
ꝓuocem᷑	prouocemur
ad	ad
hũilitatem	humilitatem
exem	exem
plo	plo
sue	sue
conũsatõis	conuersationis
ꝑ	per

Hec	Hec
ã	autem
scͥptura	scriptura
q̃	que
ibi	ibi
scͥbitur	scribitur
triplex	triplex
est	est
s.	scilicet
dictamĩa	dictamina
faciendoꝝ	faciendorum
testiõa	testimonia
diuinoꝝ	diuinorum
bñficioꝝ	beneficiorum
ꝓpͥoꝝ	propriorum
acc̃atõ	accusatio
delictoꝝ	delictorum
De	De
hiis	hiis
tribus	tribus
R	R
II	II
C	C
II	II
Gentes	Gentes

que	que
legẽ	legem
nõ	non
h̃nt	habent
naturalr̃	naturaliter
que	que
legis	legis
sunt	sunt
fa	fa
ciunt	ciunt
hi᷒	huiusmodi
legem	legem
nõ	non
habentes	habentes
ipi	ipsi
sibi	sibi
sunt	sunt
lex	lex
qui	qui
ostendũt	ostendunt
opus	opus
legis	legis
scriptũ	scriptum
in	in
cordib	cordibus

suis	suis
Ecce	Ecce
pͥmũ	primum
test̃m	testimonium
illis	illis
Reddente	Reddente
ꝯscĩa	conscientia
ipoꝝ	ipsorum
ecce	ecce
scd̃m	secundum
et	et
intra	intra
se	se
cogi	cogi
tatõem	tationem
accusantiũ	accusantium
ul̃	ue
etiã	etiam
deffẽ	deffen
denciũ	dencium
ecce	ecce
tercium	tercium
Quinto	Quinto
debent	debent
pingi	pingi

cruces	cruces
.i.	idest
assumi	assumi
pñie	penitentie
asꝑritates	asperritates
que	que
qͥdem	quidem
debẽt	debent
inungi	inungi
et	et
igne	igne
illustrari	illustrari
	quia
nõ	non
solum	solum
ferende	ferende
sunt	sunt
pacienter	pacienter
s	sed
etiã	etiam
libent̃	libenter
q̃d	quod
ꝑ	per
unctionẽ	unctionem
et	et

ar	ar
denter	denter
per	per
ignem	ignem
Uñ	Unde
B᷒	Bernardus
Qui	Qui
minatur	minatur
terrore	terrore
crucem	crucem
xp̃i	Christi
portat	portat
pacient̃	pacienter
qui	qui
ꝑficit	perficit
ĩ	in
spe	spe
portat	portat
libent̃	libenter
s	sed
qui	qui
ꝯsumatur	consumatur
in	in
karitate	karitate
amplectitur	amplectitur

iam	iam
ar	ar
denter	denter
b̃	bernardus
multi	multi
uident	uident
cruces	cruces
nr̃as	nostras
s	sed
non	non
uident	uident
unctiones	unctiones
nr̃as	nostras
qui	qui
gͥ	igitur
hoc	hoc
in	in
se	se
habebit	habebit
uere	uere
templũ	templum
ad	ad
honorem	honorem
dei	dei
de	de

dicatum	dicatum
erit	erit
Dignus	Dignus
plane	plane
ĩ	in
quo	quo
xp̃s	Christus
h̃itet	habitet
ꝑ	per
gr̃am	gratiam
ut	ut
tand̃	tandem
in	in
eo	eo
habitate	habitate
dignetur	dignetur
ꝑ	per
gl̃am	gloriam
Q̃d	Quod
ipe	ipse
nobis	nobis
prestare	prestare
dignet᷑	dignetur
Qui	Qui
uiuit	uiuit

et	et
regnat	regnat
deus	deus
per	per
om̃ia	omnia
scl̃a	secula
scl̃oꝝ	seculorum
ameN	ameN
Hic	Hic
liber	liber
scriptus	scriptus
fuit	fuit
apud	apud
cystercium	cystercium
Anno	Anno
domini	domini
mil	mil
lesimo	lesimo
CCCͦ	CCCo
IIIIͦ	IIIIo
decimo	decimo
kalẽ	kalen
das	das
marcii	marcii
Expliciunt	Expliciunt

legende	legende
sanctoꝝ	sanctorum
ul̃	ue
passionale	passionale
adbreuiatum	adbreuiatum
Scriptorem	Scriptorem
gratum	gratum
faciat	faciat
d̃s	deus
atq	atque
beatum	beatum
Et	Et
sibi	sibi
pͥmatum	primatum
tribuat	tribuat
deleat	deleat
in	in
reatum	reatum
amẽ	amen
Scribere	Scribere
qui	qui
fecit	fecit
hunc	hunc
librum	librum
non	non

malefecit	malefecit
Ille	Ille
diu	diu
duret	duret
post	post
mortem	mortem
sydera	sydera
curet	curet
amẽ	amen
Hunc	Hunc
de	de
gillento	gillento
C	C
scripsit	scripsit
non	non
pede	pede
lento	lento
Quem	Quem
deus	deus
ĩ	in
celis	celis
tradat	tradat
manib	manibus
michaelis	michaelis
AMEN	AMEN

utrũ	utrum
talia	talia
ob̃a	obiecta
ꝯ	cum
c̃ꝯstãciis	circumstanciis
talibb	talibbus
sͨ	sic
sint	sint
d̃isa	diuisa
s.	scilicet
ꝙ	quod
aliqͥs	aliquis
sic	sic
ẽ	est
dispoĩt᷒	dispositus
ꝙ	quod
tale	tale
bonũ	bonum
nõ	non
fac̃et	faceret
ꝯtemplacõne	contemplacione
minoris	minoris
boni	boni
ul̃	ue
mali	mali

s	sed
solũ	solum
cõ	con
tẽplatõne	templatione
maioris	maioris
puta	puta
ꝓ	pro
uitãdo	uitando
dãpno	dampno
XII	XII
d̃	denarios
nõ	non
iret	iret
ad	ad
eccam	ecclesiam
s	sed
ꝓ	pro
uitãda	uitanda
una	una
ũb̃atõne	uerberatione
ĩ	in
capitl̃o	capitulo
bñ	bene
iret	iret
ali᷒	alius

aut̃	autem
sic	sic
est	est
dispoĩt᷒	dispositus
ꝙ	quod
tl̃e	tale
bonũ	bonum
opus	opus
nõ	non
fac̃et	faceret
ꝯtẽplatõne	contemplatione
maioris	maioris
boni	boni
ul̃	ue
mali	mali
s	sed
solũ	solum
mi	mi
noris	noris
puta	puta
ꝓ	pro
uitãda	uitanda
una	una
ũb̃atõe	uerberatione
ĩ	in

capl̃o	capitulo
nõ	non
iret	iret
s	sed
ꝓ	pro
uitãdo	uitando
dãpno	dampno
amusionis	amusionis
XII	XII
d̃	denariorum
bñ	bene
iret	iret
l	licet
ñ	non
sine	sine
alt̃o	altero
illoꝝ	illorum
nã	nam
sic̃	sicut
ob̃a	obiecta
apud	apud
diũsos	diuersos
sic	sic
h̃nt	habent
diũsas	diuersas

c̃ꝯstãcias	circumstancias
ita	ita
ꝙ	quod
iͤ	iste
h̃t	habet
ob̃m	obiectum
ꝯ	cum
tali	tali
c̃ꝯstancia	circumstancia
ille	ille
uero	uero
alia	alia
tũc	tunc
facilr̃	faciliter
pot̃im᷒	poterimus
ꝯꝑare	comparare
act᷒	actus
ad	ad
ĩuicẽ	inuicem
si	si
uõ	uero
c̃ꝯstãcie	circumstancie
utͦbiq	utrobique
sĩt	sint
tõis	tionis

deb̃et	deberet
amitt̃et	amitteret
XII	XII
d̃	denarios
si	si
·H·	enim
gͣuit̃	grauiter
pcc̃at	peccat
cui᷒	cuius
uolũtas	uoluntas
tẽtõne	tentione
uilioris	uilioris
finis	finis
ĩclinat	inclinat
pcc̃andũ	peccandum
ita	ita
	et
m᷒	minus
ũtuose	uirtuose
a	a
qͥ	qui
ex	ex
mi᷒	minus
bono	bono
fine	fine

ĩclinat᷑	inclinatur
a	a
faciẽdũ	faciendum
si	si
·H·	enim
ut̃q	uterque
taliũ	talium
eq̃	eque
lũtarie	luntarie
ul̃	ue
ĩuolũtarie	inuoluntarie
fera	fera
ip̃m	ipsum
bonũ	bonum
uolitũ	uolitum
ꝙͣntũ	quanntum
ad	ad
h̃	hoc
nõ	non
ur̃d	uidetur
magis	magis
ul̃	ue
m᷒	minus
bñ	bene
fa	fa

ꝙͣ	quam
ali᷒	alius
ẜ	secundum
rõm	rationem
ipi᷒	ipsius
uolũtarii	uoluntarii
s	s
ꝯtĩgit	contingit
ex	ex
rõne	ratione
c̃ꝯstãcie	circumstancie
add	add
Uñ	Unde
sic̃	sicut
fortitudo	fortitudo
ẽ	est
ũtus	uirtus
nob	nob
ꝙͣ	quam
lib̃alitas	liberalitas
	et
auaricia	auaricia
pei᷒	peius
u	u
ꝙͣ	quam

timiditas	timiditas
	quia
amare	amare
ẜ	secundum
rõ	ratio
nũ	num
corꝑis	corporis
ẽ	est
meli᷒	melius
ꝙͣ	quam
amare	amare
ext̃iora	exteriora
ẜ	secundum
rõm	rationem
	et
sb̃di	subdi
ẜ	secundum
appe	appe
ꝑ	per
amorẽ	amorem
ĩordinatũ	inordinatum
bonis	bonis
ex	ex
b	bus
ẽ	est

pei᷒	peius
ꝙͣ	quam
sb̃di	subdi
ẜ	secundum
appetitũ	appetitum
	et
ANno	ANno
dñi	domini
Mͦ	Mo
CCͦ	CCo
Nonagͦ	Nonagesimo
Vͦ	Vo
nõ	non
fuit	fuit
celebratũ	celebratum
capͫ	capitulum
gñale	generale
ꝓpt̃	propter
mortẽ	mortem
ueñabilis	uenerabilis
pr̃is	patris
ma	ma
gistri	gistri
ordinis	ordinis
fr̃is	fratris

steph̃i	stephani
de	de
bisũcio	bisuncio
qui	qui
obiit	obiit
ĩ	in
ꝯuẽtu	conuentu
lu	lu
chano	chano
romane	romane
ꝓuĩcie	prouincie
ĩ	in
festo	festo
sc̃e	sancte
cecilie	cecilie
uirginis	uirginis
et	et
martiris	martiris
Anno	Anno
dñi	domini
Mͦ	Mo
CCͦ	CCo
Nonagͦ	Nonagesimo
IIIIͦ	IIIIo
ANno	ANno

dñi	domini
Mͦ	Mo
CCͦ	CCo
Nonagͦ	Nonagesimo
VIͦ	VIo
celebratũ	celebratum
fuit	fuit
LXXI	LXXI
capͫ	capitulum
gñale	generale
ĩ	in
argẽtina	argentina
ĩ	in
ꝓuincia	prouincia
theutõie	theutonie
in	in
qͦ	quo
capͦ	capitulo
fuit	fuit
elc̃us	electus
in	in
magistrũ	magistrum
ordinis	ordinis
ueñabilis	uenerabilis
pater	pater

dñs	dominus
frater	frater
Nycholaus	Nycholaus
de	de
triuisio	triuisio
qͥ	qui
tũc	tunc
erat	erat
pͥor	prior
ꝓuĩcialis	prouincialis
lõbardie	lombardie
ANno	ANno
dñi	domini
Mͦ	Mo
CCͦ	CCo
Nonagͦ	Nonagesimo
VIIͦ	VIIo
celebratũ	celebratum
fuit	fuit
LXXII	LXXII
capͫ	capitulum
gñale	generale
ueneciis	ueneciis
in	in
ꝓuĩcia	prouincia

lõbardie	lombardie
	pre
ANno	ANno
dñi	domini
Mͦ	Mo
CCCIͦ	CCCIo
celebra	celebra
tum	tum
fuit	fuit
LXXV	LXXV
capͫ	capitulum
gñale	generale
colõie	colonie
in	in
ꝓuĩcia	prouincia
th̃otonie	theotonie
in	in
quo	quo
capͦ	capitulo
fuit	fuit
elc̃us	electus
in	in
magistrũ	magistrum
ordinis	ordinis
frat̃	fratrum

B̃nard᷒	Bernardus
de	de
iuzico	iuzico
dyoc̃	dyocesis
uasaceñ	uasacensis
de	de
ꝓuĩcia	prouincia
tholosana	tholosana
qui	qui
tũc	tunc
erat	erat
pͥor	prior
ꝓuĩcialis	prouincialis
ꝓuĩcie	prouincie
nõdũ	nondum
diuise	diuise
ANno	ANno
dñi	domini
Mͦ	Mo
CCCIIͦ	CCCIIo
celebratum	celebratum
fuit	fuit
LXXVI	LXXVI
capͫ	capitulum
gñale	generale

bononie	bononie
ĩ	in
ꝓuĩcia	prouincia
lõbardie	lombardie
a	a
fato	prefato
magr̃o	magistro
͛	Bernardo
qui	qui
obiit	obiit
post	post
dictũ	predictum
capͫ	capitulum
ĩ	in
ꝯuẽtu	conuentu
treũensi	treuerensi
ĩ	in
ꝓuĩcia	prouincia
theutonie	theutonie
XVͦ	XVo
kls̃	kalendas
octobris	octobris
in	in
festo	festo
b̃ti	beati

lamb̃ti	lamberti
ANno	ANno
dñi	domini
Mͦ	Mo
CCCIIIIͦ	CCCIIIIo
celebratũ	celebratum
fuit	fuit
LXXVIII	LXXVIII
capͫ	capitulum
gñale	generale
tholose	tholose
xp̃ianus	Christianus
Ille	Ille
uere	uere
xp̃ianus	Christianus
est	est
qͥ	qui
om̃ib	omnibus
mĩam	misericordiam
facit	facit
qui	qui
nulla	nulla
oĩo	omnino
mo	mo
uet᷑	uetur

ĩiuria	iniuria
qui	qui
alienũ	alienum
dolorẽ	dolorem
tã	tan
qͣm	quam
ꝓpͥum	proprium
sentit	sentit
cui᷒	cuius
mensã	mensam
nl̃lus	nullus
paup̃	pauper
ignorat	ignorat
qui	qui
corã	coram
hõib	hominibus
in	in
gl̃ius	glorius
habet᷑	habetur
ut	ut
corã	coram
deo	deo
	et
ange	ange
lis	lis

gl̃iet᷑	glorietur
qui	qui
t̃rena	terrena
ꝯtempnit	contempnit
ut	ut
possit	possit
h̃re	habere
celestia	celestia
qui	qui
oppͥmiͭ	opprimit
pauꝑẽ	pauperem
se	se
sente	presente
nõ	non
patit᷑	patitur
qui	qui
mis̃is	miseris
sb̃uenit	subuenit
qui	qui
ad	ad
fletum	fletum
fletib	fletibus
ꝓuocat᷑	prouocatur
alienis	alienis
q̃d	quod

bene	bene
faciebat	faciebat
paulus	paulus
quis	quis
ĩfirmat᷑	infirmatur
	et
ego	ego
uõ	uero
ĩfirmor	infirmor
aug̃	augustinus
lio	libro
de	de
uita	uita
xp̃ͥana	Christiana
xp̃iani	Christiani
nom̃	nomen
ille	ille
frustͣ	frustra
sortit᷑	sortitur
qui	qui
xp̃m	Christum
m̃ime	minime
ĩmitat᷑	immitatur
quid	quid
·H·	enim

tͥ	tibi
ꝓdest	prodest
uocari	uocari
ꝙ	quod
nõ	non
es	es
	et
nom̃	nomen
uiuat	uiuat
crux	crux
est	est
atque	atque
mrty	mrty
magxim᷒	magximus
ĩ	in
s̃	sermone
natal̃	natalis
dñi	domini
ubi	ubi
fides	fides
ũitas	ueritas
f	f
xp̃s	Christus
a	a
Esuriuit	Esuriuit

xp̃s	Christus
qͥ	qui
om̃s	omnes
pa	pa
sitiuit	sitiuit
ꝑ	per
quem	quem
causat᷑	causatur
on	on
tus	tus
	et
qui	qui
sp̃ualit̃	spiritualiter
panis	panis
e	e
rienciũ	riencium
fonsq	fonsque
sitientiũ	sitientium
a	a
t̃restͥ	terrestri
fatigat᷒	fatigatus
est	est
qui	qui
se	se
nob̃	nobis

uiã	uiam
fecit	fecit
ĩ	in
celũ	celum
uelu	uelu
mutuit	mutuit
	et
obsurduit	obsurduit
corã	coram
ciantib	ciantibus
ꝑ	per
quẽ	quem
mut᷒	mutus
locu	locu
	et
surd᷒	surdus
audiuit	audiuit
uinct᷒	uinctus
est	est
de	de
ĩfirmitatũ	infirmitatum
uincl̃is	uinculis
nos	nos
sol	sol
flagellat᷒	flagellatus

est	est
qui	qui
om̃i	omni
flag	flag
loꝝ	lorum
de	de
hoĩm	hominum
corꝑib	corporibus
expulit	expulit
fix᷒	fixus
est	est
qui	qui
cruciat᷒	cruciatus
nr̃os	nostros
fi	fi
mortuu᷒	mortuus
est	est
qͥ	qui
mortuos	mortuos
susc	susc
s	sed
	et
resurrexit	resurrexit
nũꝙͣ	nunquam
moritu	moritu

si	si
uidẽt	uident
hec	hec
mõstra	monstra
qui	qui
abstinuit	abstinuit
cũctis	cunctis
b.	bus
tanꝙͣ	tanquam
ab	ab
hoĩe	homine
nec	nec
indulsit	indulsit
uentri	uentri
om̃e	omne
legum̃	legumen
qiͣ	quasi
dica	dica
tagoras	tagoras
credebat	credebat
esse	esse
magnũ	magnum
nephas	nephas
no	nom
comed̃e	comedere

hoĩ	homin
egiptii	egiptii
sed	sed
manducare	manducare
aĩalia	animalia
⁊	et
õia	omnia
legumina	legumina
ꝙ	quod
forti᷒	fortius
ẽ	est
ĩ	in
i	i
inger̃e	ingerere
retardabat	retardabat
finito	finito
libro	libro
sit	sit
laus	laus
⁊	et
gl̃a	gloria
xp̃o	Christo
am̃	amen
Iste	Iste
liber	liber

qui	qui
senatori᷒	senatorius
uocat᷑	uocatur
fuit	fuit
scͥpt᷒	scriptus
ꝑ	per
me	me
nicolaũ	nicolaum
olim	olim
de	de
ꝑ	per
anno	anno
dñi	domini
millͦ	millesimo
cccͦ	ccco
viiͦ	viio
indictiõe	indictione
vͣ	va
tp̃re	tempore
dñi	domini
clem̃tis	clementis
p	p
anno	anno
ei᷒	eius
ẜo	secundo

mẽsis	mensis
alis	aprelis
die	die
xixͣ	xixa
⁊	et
fuit	fuit
ꝯpilat᷒	compilatus
quo	quo
ad	ad
lecti	lecti
nobilẽ	nobilem
⁊	et
illustrẽ	illustrem
uirũ	uirum
dñm	dominum
Gentilẽ	Gentilem
de	de
filiis	filiis
ursi	ursi
tpr̃	tempore
sui	sui
senat᷒	senatus
P	P
Asce	Asce
oues	oues

meas	meas
in	in
io.	iohanne
Sicut	Sicut
est	est
in	in
oꝑib	operibus
mechanicis	mechanicis
ita	ita
est	est
in	in
oꝑibus	operibus
nostre	nostre
salutis	salutis
suo	suo
modo	modo
Sed	Sed
uidemus	uidemus
quod	quod
qñ	quando
artifex	artifex
aͥcuius	alicuius
ar	ar
tis	tis
mechãice	mechanice

debet	debet
aͥcubi	alicubi
ꝓficisci	proficisci
instruit	instruit
aͥꝙͤ	aliquem
de	de
ar	ar
te	te
sua	sua
pͤcipue	precipue
et	et
inforͣt	informat
cui	cui
cõmittit	committit
officiũ	officium
suũ	suum
post	post
recessũ	recessum
suũ	suum
exeꝙͤdum	exequendum
Sic	Sic
fecit	fecit
dñs	dominus
ih̃s	iesus
xp̃s	Christus

ipe	ipse
·H·	enim
qui	qui
erat	erat
in	in
hoc	hoc
mũdo	mundo
rector	rector
et	et
pastor	pastor
ouiũ	ouium
tocius	tocius
gͤgis	gregis
eccͤ	ecclesie
recessurus	recessurus
a	a
mũdo	mundo
et	et
ascensurus	ascensurus
in	in
celũ	celum
loco	loco
sui	sui
in	in
stituit	stituit

pͤlati	prelati
pͤsidentis	presidentis
pasce	pasce
scd̃m	secundum
est	est
condc̃o	condictio
pp̃	pape
obedientis	obedientis
oues	oues
t̃ciũ	tercium
est	est
affc̃o	affectio
xͥ	Christi
ꝯ	con
mͭtentis	mittentis
in	in
eas	eas
obligacio	obligacio
pͤsidentis	presidentis
est	est
in	in
subuẽiendo	subueniendo
cũ	cum
sollicitudĩe	sollicitudine
Condc̃o	Condictio

pp̃	pape
est	est
in	in
obediendo	obediendo
cũ	cum
mansuetudine	mansuetudine
affc̃o	affectio
cõmͭtentis	committentis
est	est
in	in
cõmendando	commendando
cũ	cum
ten͛itudĩe	teneritudine
Pͥm̃	Primum
gͦ	ergo
quod	quod
noͣtur	notatur
in	in
ũbis	uerbis
ꝓpoĩtis	propositis
est	est
obligacio	obligacio
pͤlati	prelati
pͤsidentis	presidentis
que	que

consistit	consistit
in	in
subuẽiendo	subueniendo
cũ	cum
sollicitudĩe	sollicitudine
in	in
h̃	hoc
quod	quod
dicit᷑	dicitur
pasce	pasce
Ad	Ad
hoc	hoc
·H·	enim
obligant᷑	obligantur
pͤsidentes	presidentes
et	et
pͤlati	prelati
ut	ut
gͤgem	gregem
sͥ	sibi
cõ	com
missũ	missum
sollicite	sollicite
pascant	pascant
nõ	non

ut	ut
tondeant	tondeant
uel	uel
excorient	excorient
de	de
hoc	hoc
pͭ	potest
expõi	exponi
quod	quod
dr̃d	dicitur
Iͣ	Ia
pe.	petri
V	V
pascite	pascite
qui	qui
in	in
uobis	uobis
est	est
gͤgem	gregem
cõmissũ	commissum
s.	scilicet
pͣcõnis	praedicacionis
ũbo	uerbo
ut	ut
in	in

dilectione	dilectione
dei	dei
et	et
cogͥtione	cognitione
sui	sui
ꝓficiat	proficiat
cõũsacionis	conuersacionis
exo	exemplo
ne	ne
gͤgem	gregem
in	in
uia	uia
moꝝ	morum
errare	errare
faciat	faciat
Ambulate	Ambulate
in	in
dilc̃one	dilectione
sicut	sicut
et	et
xᷤ	Christus
dilexit	dilexit
nos	nos
ad	ad
ephesᷤ	ephesos

V	V
sapiens	sapiens
in	in
ꝓũbiis	prouerbiis
uitam	uitam
iusti	iusti
cõꝑat	comparat
luce	luce
.	.
ꝓu͛	prouer
biis	biis
iiii	iiii
iustoꝝ	iustorum
semita	semita
q.	quasi
lux	lux
splendẽs	splendens
procedit	procedit
et	et
cͤscit	crescit
us	usque
ad	ad
ꝑfc̃m	perfectum
diem	diem
lux	lux

aũ	autem
diei	diei
sic	sic
se	se
h̃t	habet
quod	quod
semꝑ	semper
cͤscit	crescit
uel	uel
decͤscit	decrescit
nõꝙͣ	nonquam
in	in
eod̃	eodem
statu	statu
ꝑmanet	permanet
Sic	Sic
est	est
de	de
uita	uita
iusti	iusti
semꝑ	semper
·H·	enim
cͤsc̃	crescit
uel	uel
decͤscit	decrescit

in	in
bono	bono
	quia
sicut	sicut
dicit	dicit
Ber	Ber
nardus	nardus
in	in
uia	uia
dei	dei
nõ	non
ꝓgͤdi	progredi
regͤdi	regredi
est	est
et	et
idcirco	idcirco
apl̃us	apostolus
in	in
ũbis	uerbis
ꝓpoĩtis	propositis
non	non
hortatur	hortatur
ad	ad
ꝓficiendũ	proficiendum
in	in

uia	uia
moꝝ	morum
dicẽs	dicens
ambulateetc̃	ambulateetcetera
In	In
quibus	quibus
ũbis	uerbis
pͦ	primo
nos	nos
hortatur	hortatur
apl̃us	apostolus
ad	ad
ꝓfectum	profectum
continuũ	continuum
ambulate	ambulate
scd̃o	secundo
sub	sub
dit	dit
modũ	modum
ꝯgruũ	congruum
in	in
dilectione	dilectione
dei	dei
t̃cio	tercio
subiũg̃	subiungit

exẽplũ	exemplum
pͤcipuũ	precipuum
Sicut	Sicut
et	et
xᷤ	Christus
dilexit	dilexit
nos	nos
Primo	Primo
gͥ	igitur
nos	nos
hortatur	hortatur
apl̃us	apostolus
ad	ad
ꝑfc̃m	perfectum
continuũ	continuum
cũ	cum
dicitur	dicitur
ambulate	ambulate
nõ	non
pedibus	pedibus
corporis	corporis
sed	sed
oꝑibus	operibus
uirtutis	uirtutis
ꝑ	per

ficiendo	ficiendo
s.	scilicet
de	de
uirtute	uirtute
in	in
uirtutem	uirtutem
nõ	non
iacendo	iacendo
cũ	cum
uoluptuosis	uoluptuosis
ꝑ	per
carnalem	carnalem
cõcupĩam	concupiscientiam
nõ	non
sedendo	sedendo
cũ	cum
insidiosis	insidiosis
ꝑ	per
intentionis	intentionis
malitiam	malitiam
nõ	non
stãdo	stando
cũ	cum
accidi	accidi
osis	osis

per	per
ignauiam	ignauiam
et	et
pigͥtiam	pigritiam
nõ	non
equitando	equitando
cũ	cum
põpo	pompo
sis	sis
et	et
ambitiosis	ambitiosis
ꝑ	per
elacõm	elacionem
et	et
suꝑbiam	superbiam
sed	sed
ambulã	ambulan
do	do
cũ	cum
laboriosis	laboriosis
et	et
festinantibus	festinantibus
ad	ad
pr̃iam	patriam
de	de

isto	isto
ꝑ	per
fc̃ũ	fectum
ambul̃onis	ambulationis
dr̃d	dicitur
Michee	Michee
VI	VI
iudicabo	iudicabo
tͥ	tibi
o	o
homo	homo
gelii	gelii
Secundu	Secundu
Matheum	Matheum
ix	ix
IN	IN
illo	illo
tp̃re	tempore
Angl̃s	Angelus
dñi	domini
apparuit	apparuit
in	in
sõnis	somnis
ioseph	ioseph
dicẽs	dicens

Surge	Surge
	et
accipe	accipe
puerũ	puerum
et	et
matrẽ	matrem
eius	eius
	et
fuge	fuge
in	in
egiptũ	egiptum
	et
esto	esto
ibi	ibi
usq	usque
dũ	dum
dicam	dicam
tibi	tibi
Et	Et
rel̃	relicta
homelia	homelia
lectiõis	lectionis
eiusdem	eiusdem
in	in
xp	xp

ma	ma
mari	mari
ũ	um
fid	fid
mẽ	men
e	e
ꝑ	per
pro	pro
redd	redd
ram	ram
ꝑegͥnus	peregrinus
ꝑficio	perficio
pericl̃m	periculuum
periuriũ	periurium
perseũanͣ	perseuerantia
peticio	peticio
petr᷒	petrus
apl̃s	apostolus
petr᷒	petrus
martir	martir
pietas	pietas
pigricia	pigricia
piscator	piscator
pollucio	pollucio
potencia	potencia

potus	potus
preceptũ	preceptum
predestinacõ	predestinacio
predicacio	predicacio
predicator	predicator
predo	predo
prelatus	prelatus
prelacio	prelacio
positus	prepositus
sciencia	presciencia
sermo	sermo
serpens	serpens
s̃uiciũ	seruicium
seũitas	seueritas
signũ	signum
silenciũ	silencium
siluest̃	siluester
simia	simia
symon	symon
mag᷒	magus
symon	symon
	et
iudas	iudas
symonia	symonia
sĩplicitas	simplicitas

simulacio	simulacio
singl̃aritas	singularitas
sitis	sitis
sobrietas	sobrietas
sompn᷒	sompnus
sortilegiũ	sortilegium
spectacl̃m	spectaculuum
solitudo	solitudo
solucio	solucio
sponsalia	sponsalia
status	status
Finis	Finis
huic	huic
uenit	uenit
	et
ecce	ecce
nũc	nunc
uenit	uenit
hi᷒	huius
alphabeti	alphabeti
finis	finis
illi	illi
gr̃as	gratias
qui÷	quiest
al	al

pha	pha
	et
o	o
pͥncipiũ	principium
	et
finis	finis
Ꝙ	Quod
qͥ	qui
hũc	hunc
libꝝ	librum
lecturi	lecturi
sunt	sunt
orare	orare
deuote	deuote
dig	dig
nent᷑	nentur
ut	ut
hoꝝ	horum
ꝯpi	compi
lator	lator
c᷒	cuius
nom̃	nomen
ĩ	in
ꝓlo	prolo
go	go

ꝯtinet᷑	continetur
eoꝝ	eorum
o	o
racõib	racionibus
adiutus	adiutus
finẽ	finem
legatũ	legatum
ꝯsequi	consequi
m̃eat᷑	mereatur
Ꝙ	Quod
ipe	ipse
pr̃a	presta
re	re
dignetur	dignetur
sc̃a	sancta
trinitas	trinitas
un᷒	unus
de᷒	deus
sñ	sine
fine	fine
benedc̃us	benedictus
in	in
scl̃a	secula
scl̃oꝝ	seculorum
amen	amen

Anno	Anno
dñi	domini
mͦ	mo
cccmo	cccmo
viii	viii
FRatrẽ	FRatrem
Guill̃m	Guillelmum
petri	petri
de	de
godino	godino
baioneñ	baionensis
ord̃	ordinis
fr̃m	fratrum
dicatoꝝ	predicatorum
magr̃m	magistrum
ĩ	in
theologia	theologia
ꝑisĩ	parisiensem
assũpsit	assumpsit
in	in
presbiterium	presbiterium
cardinalẽ	cardinalem
tituli	tituli
sc̃e	sancte
cecilie	cecilie

Erat	Erat
ãt	autem
tc̃	tunc
l̃ctor	lector
sacri	sacri
palacii	palacii
uͥ	ubi
legerat	legerat
iã	iam
vi	vi
annis	annis
fueratq	fueratque
pͥor	prior
ꝓuĩcial̃	prouincialis
ĩ	in
ꝓuincia	prouincia
ꝓuĩcie	prouincie
ord̃	ordinis
dic̃	predicatorum
primo	primo
et	et
in	in
ꝓuincia	prouincia
tholosana	tholosana
hũc	hunc

matheũ	matheum
de	de
urssinis	urssinis
de	de
c̃itate	ciuitate
romana	romana
magr̃m	magistrum
ĩ	in
theulogia	theulogia
ꝑisĩ	parisiensem
de	de
cui	cuius
ospicio	ospicio
añ	ante
longe	longe
fuerãt	fuerant
assũpti	assumpti
a	a
qͥdam	quidam
pape	pape
et	et
eciã	eciam
inperatores	inperatores
nͨ	nec
nõ	non

dñi	domini
mͦ	mo
cccͦ	ccco
xxͦ	xxo
viiͦ	viio
iste	iste
fuit	fuit
in	in
vii	vii
capo	capitulo
gñali	generali
burdegal̃	burdegale
celebrato	celebrato
anno	anno
dñi	domini
mͦ	mo
cccͦ	ccco
xxͦ	xxo
iiiiͦ	iiiio
erat	erat
eĩ	enim
pͥor	prior
ꝓuĩcial̃	prouincialis
romane	romane
ꝓuĩcie	prouincie

in	in
quo	quo
capl̃o	capitulo
fuit	fuit
grauit̃	grauiter
infirm	infirmus
Fr̃em	Fratrem
Geraldũ	Geraldum
de	de
domaro	domaro
Briueñ	Briuensis
ord̃	ordinis
fr̃m	fratrum
dicaꝝ	predicarum
magr̃m	magistrum
ĩ	in
theologia	theologia
ꝑisĩ	parisiensem
assũpsit	assumpsit
ĩ	in
br̃m	presbiterum
card̃	cardinalem
tͥtͥ	tituli
sc̃e	sancte
sabine	sabine

dñs	dominus
clemens	clemens
papa	papa
vi᷒	vius
sa	sa
sab̃to	sabbato
ĩ	in
ieiuniis	ieiuniis
iiiior	iiiior
fest̃	festiuitate
exaltacõis	exaltacionis
sc̃e	sancte
crucis	crucis
cũ	cum
uomitu	uomitu
cipue	precipue
in	in
egͥtudinib	egritudinibus
acutis	acutis
et	et
horis	horis
crisis	crisis
Et	Et
qñ	quandoque
est	est

cũ	cum
cõitate	communitate
ñuoꝝ	neruorum
uenientiũ	uenientium
ad	ad
ea	ea
a	a
c̃ebro	cerebro
	et
nucha	nucha
cũ	cum
ꝯũitate	communitate
quã	quam
c̃ebꝝ	cerebrum
h̃t	habet
cũ	cum
eis	eis
Fen	Fen
noua	noua
de	de
dispositio	dispositio
nibus	nibus
gutturis	gutturis
cuius	cuius
est	est

unus	unus
tractatus	tractatus
cõ	con
tinens	tinens
tresdecim	tresdecim
capitu	capitu
la	la
Capitulũ	Capitulum
primũ	primum
est	est
de	de
anathomia	anathomia
gutturiᷤ	gutturis
PEr	PEr
guttur	guttur
intelligim᷒	intelligimus
spatiũ	spatium
ĩ	in
quo	quo
sunt	sunt
meat᷒	meatus
hanelit᷒	hanelitus
et	et
cibi	cibi
Et	Et

de	de
eo	eo
sunt	sunt
additõ	additio
que	que
est	est
una	una
Et	Et
amigdale	amigdale
Et	Et
galsamathi	galsamathi
Et	Et
tu	tu
quid̃	quidem
iam	iam
sci	sci
uisti	uisti
anathomiã	anathomiam
mery	mery
et	et
anͣm	anathomiam
epyglotis	epyglotis
Una	Una
uõ	uero
est	est

sub̃ia	substantia
carnosa	carnosa
pendens	pendens
supra	supra
supremã	supremam
ꝑ	par
tẽ	tem
epiglotis	epiglotis
sicut	sicut
uelam̃	uelamen
Et	Et
eius	eius
quid̃	quidem
iuuam̃tũ	iuuamentum
est	est
gͣdatõ	gradatio
aeris	aeris
ut	ut
non	non
ꝑcutiat	percutiat
suo	suo
frigore	frigore
pl̃mo	pulmo
nem	nem
subito	subito

Et	Et
ꝓh̃eat	prohibeat
pulũem	puluerem
	et
fumũ	fumum
Et	Et
ut	ut
sit	sit
ꝑcutiens	percutiens
uocem	uocem
qua	qua
confortet᷑	confortetur
et	et
magnifi	magnifi
cetur	cetur
qiͣ	quasi
ipa	ipsa
sit	sit
porta	porta
custodiens	custodiens
suꝑ	super
exitũ	exitum
uocis	uocis
qͣntitate	quantitate
sua	sua

Et	Et
p̃p	propter
hoc	hoc
uocet	uocet
ei᷒	eius
incisio	incisio
uoci	uoci
et	et
ꝑat	preparat
pl̃monẽ	pulmonem
ad	ad
recipiendũ	recipiendum
frig᷒	frigus
et	et
nocum̃tũ	nocumentum
ei᷒	eius
et	et
tussim	tussim
ab	ab
eo	eo
Due	Due
uõ	uero
amigdale	amigdale
sunt	sunt
due	due

car	car
nes	nes
nate	nate
in	in
radice	radice
lingue	lingue
tendentes	tendentes
ad	ad
suꝑiora	superiora
ac	ac
dubium	dubium
non	non
est	est
Idem	Idem
qͣre	quare
die	die
do	do
minico	minico
sac̃dotũ	sacerdotum
ordinacões	ordinaciones
cele	cele
brant᷑	brantur
QUod	QUod
in	in
die	die

dñico	dominico
or	or
dinaciones	dinaciones
sac̃dotũ	sacerdotum
ep̃oꝝ	episcoporum
celebrã	celebran
tur	tur
nõ	non
tm̃	tantum
ex	ex
consuetudĩe	consuetudine
set	set
eciã	eciam
ex	ex
apl̃ica	apostolica
nouim᷒	nouimus
uẽire	uenire
doctrina	doctrina
scriptura	scriptura
act᷒	actus
xiii	xiii
ũsus	uersus
pͥn	princeps
mãifestante	manifestante
q̃d	quod

cũ	cum
apl̃i	apostoli
paulũ	paulum
	et
barnabam	barnabam
ex	ex
sp̃s	spiritus
sc̃i	sancti
cepto	precepto
ad	ad
euͣngl̃ium	euangelium
gentib	gentibus
mitt̃ent	mitterent
di	predi
candũ	candum
ieiunantes	ieiunantes
	et
orantes	orantes
impo	impo
sũunt	suerunt
eis	eis
manus	manus
ut	ut
intl̃ligamus	intelligamus
qͣnta	quanta

	et
danciũ	dancium
	et
accipienciũ	accipiencium
deuoci	deuoci
one	one
curand̃	curandum
sit	sit
ne	ne
tante	tante
bñdc̃onis	benedictionis
sacr̃m	sacramentum
neggligent̃	neggligenter
uideat᷑	uideatur
imple	imple
tũ	tum
	et
iõ	ideo
pie	pie
	et
laudabl̃r	laudabilliter
apl̃icis	apostolicis
morẽ	morem
gesẜis	gesseris
institutis	institutis

si	si
hͣnc	hanc
ordinãdo	ordinando
rũ	rum
sac̃do	sacerdo
c	c
tũ	tum
forͣm	formam
ꝑ	per
eccl̃ias	ecclesias
quibus	quibus
dñs	dominus
esse	preesse
te	te
uoluit	uoluit
̃	etiam
ipe	ipse
ẜuaũis	seruaueris
icii	icii
ac	ac
mediane	mediane
ebdomade	ebdomade
	et
sabb̃i	sabbati
ieiunio	ieiunio

circa	circa
uesꝑas	uesperas
ip̃as	ipsas
ordĩacões	ordinaciones
noũitis	noueritis
celebͣndas	celebrandas
Nec	Nec
cuiuslib	cuiuslibet
uti	uti
litatis	litatis
c̃a	causa
pbr̃m	presbiterum
seu	seu
dyaconẽ	dyaconem
hiis	hiis
ferre	preferre
audeant	audeant
qui	qui
añ	ante
ipos	ipsos
fũint	fuerint
ordinati	ordinati
dist̃	distinctio
lxxvi	lxxvi
QUib	QUibus

tp̃rib	temporibus
ieiunia	ieiunia
celebͣnda	celebranda
sunt	sunt
calixtus	calixtus
ppͣ	papa
det̃minat	determinat
scͥ	scri
bens	bens
bñdc̃o	benedicto
ep̃o	episcopo
quib	quibus
tp̃rib	temporibus
ieiuni	ieiuni
a	a
celebren	celebren
tur	tur
IEiuniũ	IEiunium
q̃d	quod
ter	ter
i	i
ap̃	apud
nos	nos
in	in
anno	anno

celebrare	celebrare
di	di
dicistis	dicistis
ꝯuẽiencius	conueniencius
nob̃	nobis
nũc	nunc
ꝑ	per
qͣ	qua
tuor	tuor
temꝑa	tempora
f̃i	fieri
dec̃nim᷒	decernimus
ut	ut
sic̃	sicut
annus	annus
ꝑ	per
qͣtuor	quatuor
uoluit̃	uoluiter
tpr̃	tempora
sic	sic
	et
nos	nos
qͣternũ	quaternum
sollempne	sollempne
agam᷒	agamus

pocior	pocior
est	est
conditõ	conditio
possidentis	possidentis
IDem	IDem
CUm	CUm
con	con
stat	stat
per	per
eum	eum
quomin᷒	quominus
conditõ	conditio
impleatur	impleatur
h̃ri	haberi
d	debet
ꝑinde	perinde
ac	ac
si	si
impleta	impleta
fuiss	fuisse
IDem	IDem
Quod	Quod
alicui	alicui
suo	suo
non	non

licet	licet
noĩe	nomine
nec	nec
alieno	alieno
licebit	licebit
IDem	IDem
Potest	Potest
quis	quis
per	per
alium	alium
quod	quod
po	po
test	test
fac̃e	facere
ꝑ	per
se	se
ip̃m	ipsum
IDem	IDem
In	In
malis	malis
promissis	promissis
fidem	fidem
nõ	non
expedit	expedit
obẜuari	obseruari

IDem	IDem
In	In
alt̃natiuis	alternatiuis
debitoris	debitoris
ẽ	est
electõ	electio
et	et
sufficit	sufficit
alt̃m	alterum
adĩpleri	adimpleri
IDem	IDem
Qui	Qui
ad	ad
agendũ	agendum
admittit᷑	admittitur
ẽ	est
ad	ad
excipiẽdũ	excipiendum
ml̃to	multo
magis	magis
admittẽd᷒	admittendus
IDem	IDem
Qui	Qui
facit	facit
ꝑ	per

alium	alium
est	est
ꝑinde	perinde
ac	ac
si	si
faciat	faciat
ꝑ	per
se	se
ip̃m	ipsum
IDem	IDem
Factũ	Factum
legitime	legitime
.i.	idest
ꝯplete	complete
retractari	retractari
nõ	non
debet	debet
licet	licet
casus	casus
postea	postea
eueniat	eueniat
exactum	exactum
it̃m	iterum
exigatur	exigatur
IDem	IDem

CUm	CUm
quid	quid
una	una
uia	uia
nõ	non
prohibe	prohibe
tur	tur
alicui	alicui
ad	ad
id	id
alia	alia
nõ	non
d	debet
admitti	admitti
IDem	IDem
Contractus	Contractus
ex	ex
conuẽ	conuen
tõne	tione
legem	legem
acciꝑe	accipere
dinoscũt᷑	dinoscuntur
IDe	IDem
Danpnũ	Danpnum
quod	quod

quis	quis
sua	sua
culpa	culpa
sen	sen
tit	tit
sibi	sibi
d	debet
nõ	non
aliis	aliis
ĩputari	imputari
IDe	IDem
Infamib	Infamibus
porte	porte
nõ	non
pateãt	pateant
dignitum	dignitatum
IDem	IDem
Certum	Certum
est	est
ꝙ	quod
is	is
ꝯmͭ	commit
tit	tit
in	in
legem	legem

qui	qui
legis	legis
uerba	uerba
cõ	com
plectens	plectens
contra	contra
legis	legis
nittitur	nittitur
uoluntatem	uoluntatem
Explicit	Explicit
liber	liber
sextus	sextus
decre	decre
talium	talium
conpletus	conpletus
per	per
die	die
lune	lune
ĩ	in
uigilia	uigilia
b̃ti	beati
martini	martini
hyemalis	hyemalis
deo	deo
gracias	gracias

anno	anno
dñi	domini
mͦ	mo
cccͦ	ccco
xvͦ	xvo
In	In
studio	studio
dicti	dicti
hic	hic
ẽ	est
uer	uerus
ꝓpheta	propheta
qui	qui
uẽtur	uenturus
ĩ	in
mũdũ	mundum
Est	Est
aut̃	autem
ualde	ualde
ꝯuẽens	conuenens
ꝙ	quod
aduẽt	aduentus
dñi	domini
ĩ	in
cedẽte	precedente

dñica	dominica
inchoet᷑	inchoetur
ut	ut
eccia	ecclesia
ad	ad
aduẽtũ	aduentum
xp̃i	Christi
ei	eius
c̃tifica	certifica
ꝓmissiõe	promissione
ꝯsolata	consolata
respirãs	respirans
deuoci	deuocius
⁊	et
ueri	uerius
clamat	clamat
At	At
te	te
leuaui	leuaui
aĩa	animam
meã	meam
Ad	Ad
cui	cuius
ꝯtẽplacõe	contemplacionem
aĩe	anime

nr̃e	nostre
sic	sic
leuẽt᷑	leuentur
ut	ut
ĩ	in
aduẽtu	aduentu
districti	districti
iudic̃	iudicis
beat̃	beatis
sociẽt᷑	socientur
ꝙ	quod
graciose	graciose
nob̃	nobis
ꝯcedat	concedat
qui	qui
sñ	sine
fĩe	fine
uiuit	uiuit
⁊	et
regnat	regnat
amen	amen
aͦ	anno
dñi	domini
mͦ	mo
ccccͦ	cccco

isto	isto
ãno	anno
finit	finitus
⁊	et
ꝯplet	completus
ẽ	est
iste	iste
lib̃	liber
laus	laus
tibi	tibi
sit	sit
xp̃e	Christe
quoniam	quoniam
liber	liber
explicit	explicit
iste	iste
per	per
manus	manus
iohã	iohan
nis	nis
leufferswillen	leufferswillen
scriptorẽ	scriptorem
nos	nos
tiam	tiam
considerans	considerans

dicit	dicit
qui	qui
de	de
t̃ra	terra
est	est
de	de
terra	terra
loquitur	loquitur
qͥ	qui
de	de
celo	celo
uenit	uenit
super	super
omnes	omnes
ẽ	est
Tu	Tu
autem	autem
domine	domine
r̃	responsorium
Descẽ	Descen
det	det
dominus	dominus
sicut	sicut
pluuia	pluuia
in	in

uel	uel
lus	lus
Orietur	Orietur
in	in
dieb	diebus
eius	eius
i᷒ticia	iusticia
et	et
habundancia	habundancia
pacis	pacis
ũ	uersus
Et	Et
ado	ado
rabunt	rabunt
eum	eum
omnes	omnes
reges	reges
om̃s	omnes
gentes	gentes
seruient	seruient
ei	ei
Orietur	Orietur
l̃	lectio
viiiͣ	viiia
Cur	Cur

in	in
carc̃e	carcere
positus	positus
mittens	mittens
discipulos	discipulos
requirit	requirit
tu	tu
es	es
qui	qui
uenturus	uenturus
eᷤ	es
an	an
alium	alium
expectamus	expectamus
tãꝙͣ	tanquan
si	si
ignoret	ignoret
quem	quem
õnderat	ostenderat
et	et
an	an
ipe	ipse
sit	sit
nesciat	nesciat
quem	quem

ip̃m	ipsum
eẽ	esse
ꝓph̃ando	prophetando
baptisando	baptisando
ostendendo	ostendendo
clamauerat	clamauerat
s	sed
hec	hec
cicius	cicius
questio	questio
soluitur	soluitur
si	si
geste	geste
rei	rei
tempus	tempus
et	et
ordo	ordo
pensetur	pensetur
Tu	Tu
autẽ	autem
r̃	responsorium
monteᷤ	montes
rem	rem
an	an
ip̃e	ipse

eciam	eciam
ad	ad
inferni	inferni
clau	clau
stra	stra
descendat	descendat
Quem	Quem
enim	enim
precurrens	precurrens
mundo	mundo
nuncia	nuncia
uerat	uerat
hunc	hunc
moriendo	moriendo
et	et
ad	ad
inferos	inferos
currebat	precurrebat
Tu	Tu
aut̃	autem
r̃	responsorium
Ecce	Ecce
radix	radix
iesse	iesse
ascendet	ascendet

in	in
sa	sa
lutem	lutem
populorum	populorum
ip̃m	ipsum
gentes	gentes
deprecabuntur	deprecabuntur
Et	Et
erit	erit
nomẽ	nomen
eius	eius
gloriosum	gloriosum
ũ	uersus
Dabit	Dabit
illi	illi
dominus	dominus
deus	deus
sedem	sedem
dauid	dauid
pr̃is	patris
eius	eius
et	et
regnabit	regnabit
domo	domo
iacob	iacob

ĩ	in
e	e
t̃num	ternum
Et	Et
erit	erit
Gloria	Gloria
pr̃i	patri
r̃	responsorium
Ec	Ec
ce	ce
radix	radix
ũ	uersus
añ	ante
l̃	laudes
Ostende	Ostende
In	In
l̃	laudibus
ã	antiphona
Ueniet	Ueniet
dominus	dominus
et	et
nõ	non
tardabit	tardabit
et	et
illuminabit	illuminabit

dum	dum
scelestis	scelestis
primoq	primoque
christi	christi
quadrin	quadrin
gentesimo	gentesimo
nati	nati
dieq	dieque
uere	uere
secunda	secunda
uice	uice
sima	sima
iani	iani
Antonius	Antonius
dictus	dictus
sancii	sancii
cognomine	cognomine
fultus	fultus
Ispanus	Ispanus
natu	natu
astigie	astigie
fõ	fon
te	te
perunctus	perunctus
hunc	hunc

librum	librum
scripsit	scripsit
ius	ius
su	su
sanctissimi	sanctissimi
patris	patris
Qui	Qui
cunctis	cunctis
pandit	pandit
celes	celes
tia	tia
Regna	Regna
beatis	beatis
Pro	Pro
huius	huius
statu	statu
oret	oret
plebs	plebs
christi	christi
fidelis	fidelis
Qui	Qui
ut	ut
eam	eam
saluet	saluet
pressu	pressu

ras	ras
subit	subit
in	in
terris	terris
ymo	ymo
ut	ut
plebis	plebis
christus	christus
abstergat	abstergat
peccata	peccata
Pius	Pius
pastor	pastor
oret	oret
qui	qui
est	est
dignus	dignus
uita	uita
beata	beata
Qui	Qui
fec̃	fecit
hos	hos
ũsus	uersus
deuotus	deuotus
nim᷒	nimus
ꝓhẽialit̃	prohemialiter

dicta	dicta
sint	sint
tanta	tanta
DIcamus	DIcamus
autem	autem
resumẽtes	resumentes
quoniam	quoniam
omnis	omnis
cogͥtio	cognitio
et	et
electio	electio
bonũ	bonum
aliq̃d	aliquod
desiderat	desiderat
quid	quid
est	est
hoc	hoc
q̃d	quod
dicimus	dicimus
Ciuilem	Ciuilem
desiderare	desiderare
et	et
quid	quid
est	est
omnium	omnium

operatorum	operatorum
sũmũ	summum
bonũ	bonum
Nomine	Nomine
quidẽ	quidem
ig᷑	iguitur
fere	fere
a	a
pl̃imis	plurimis
cõfessũ	confessum
est	est
felicitatem	felicitatem
eni	enim
et	et
multi	multi
et	et
ex	ex
cellentes	cellentes
dicũt	dicunt
bene	bene
uiũe	uiuere
aut̃	autem
et	et
bñ	bene
oꝑari	operari

idem	idem
existimãt	existimant
ei	ei
q̃d	quod
est	est
esse	esse
felicem	felicem
de	de
felicitate	felicitate
aut̃	autem
29	29
De	De
qͣlitate	qualitate
uisionis	uisionis
qua	qua
ĩ	in
futuro	futuro
scl̃o	seculo
sc̃i	sancti
deum	deum
ui	ui
debunt	debunt
30	30
De	De
eterna	eterna

felicitate	felicitate
ciuitatis	ciuitatis
dei	dei
sabb̃oq	sabbatoque
ꝑpetuo	perpetuo
31	31
De	De
oꝑis	operis
ꝯsũmatõne	consummatione
cum	cum
gr̃aꝝ	gratiarum
actione	actione
Explicit	Explicit
tabula	tabula
libri	libri
de	de
ciuitate	ciuitate
dei	dei
bt̃i	beati
Augustini	Augustini
que	que
scripta	scripta
fuit	fuit
Anno	Anno
dñi	domini

Mͦ	Mo
CCCCͦ	CCCCo
pͥ	pri
Marcii	Marcii
die	die
26ͣ	26a
uigente	uigente
scismate	scismate
et	et
ppͣ	papa
benedc̃o	benedicto
13ͦ	13o
in	in
palatio	palatio
Auinioneñ	Auinionensis
sub	sub
clau	clau
sura	sura
iam	iam
per	per
bien	bien
niũ	nium
detẽ	deten
to	to
ꝓ	pro

th	th
dolor	dolor
Ce	Ce
escripst	escripst
Guyllemin	Guyllemin
Cronier	Cronier
pour	pour
des	des
prelats	prelats
le	le
per	per
mier	premier
Et	Et
se	se
bien	bien
son	son
nom	nom
weulz	weulz
scavoir	scavoir
Pren	Pren
le	le
Rouge	Rouge
et	et
laysse	laysse
le	le

noir	noir
O	O
mortalium	mortalium
miseranda	miseranda
conditio	conditio
que	que
semper	semper
in	in
arduum	arduum
labentium	labentium
inaniter	inaniter
tendis	tendis
ut	ut
lapsu	lapsu
grauiore	grauiore
ruas	ruas
Queris	Queris
hic	hic
fulgentia	fulgentia
du	du
nores	nores
eximios	eximios
longosq	longosque
potentatus	potentatus
ubi	ubi

nulla	nulla
potentia	potentia
potens	potens
e	e
uerus	uerus
honos	honos
nullum	nullum
consistens	consistens
dyadema	dyadema
s	sed
omnia	omnia
casus	casus
human	human
et	et
quicquid	quicquid
in	in
altum	altum
fortuna	fortuna
tulit	tulit
ruitura	ruitura
leuat	leuat
Respice	Respice
reges	reges
et	et
regna	regna

quon	quon
peria	peria
inter	inter
laudantium	laudantium
ora	ora
atq	atque
mirantium	mirantium
repente	repente
corruisse	corruisse
ut	ut
detur	detur
inte	inte
sectantur	sectantur
non	non
ad	ad
id	id
quo	quo
tendunt	tendunt
euolant	euolant
s	sed
ad	ad
yma	yma
dedecorose	dedecorose
sepissime	sepissime
iuxta	iuxta

euangelicum	euangelicum
dictum	dictum
Qui	Qui
se	se
exaltat	exaltat
humiliabitur	humiliabitur
luce	luce
xiiii	xiiii
Quisꝗs	Quisquis
mes	mes
uirtutum	uirtutum
esse	esse
concupiscit	concupiscit
stabili	stabili
fixoq	fixoque
gradu	gradu
manere	manere
inter	inter
radiant	radiant
choros	choros
feliciter	feliciter
collocari	collocari
normam	normam
uirtutum	uirtutum
ut	ut

hic	hic
dux	dux
noster	noster
fecit	fecit
discat	discat
uni	uni
ut	ut
inquit	inquit
Tullius	Tullius
in	in
philippicis	philippicis
Omnia	Omnia
alia	alia
incerta	incerta
sunt	sunt
caduca	caduca
et	et
mobilia	mobilia
est	est
una	una
altissimis	altissimis
infixa	infixa
radicibus	radicibus
que	que
nulla	nulla

ui	ui
labefactari	labefactari
potest	potest
nec	nec
dimo	dimo
Quicũq	Quicunque
gͦ	ergo
uirtutis	uirtutis
uestigia	uestigia
sequetur	sequetur
ut	ut
hic	hic
dux	dux
inclitus	inclitus
merito	merito
sibi	sibi
dicetur	dicetur
qu	qu
principio	principio
diximus	diximus
posuit	posuit
eum	eum
ducem	ducem
uirtutum	uirtutum
uniuersarum	uniuersarum

s	sed
dux	dux
noster	noster
inclitus	inclitus
mente	mente
celo	celo
deditus	deditus
eterni	eterni
ducis	ducis
signa	signa
mu	mu
cutus	cutus
ergo	ergo
illum	illum
deus	deus
posuit	posuit
ducem	ducem
uirtutum	uirtutum
uniuersarum	uniuersarum
Prima	Prima
pars	pars
an	an
patet	patet
per	per
illud	illud

apostoli	apostoli
secunde	secunde
thesalõicenses	thesalonicenses
pͥmo	primo
Non	Non
enim	enim
dedit	dedit
nobis	nobis
deus	deus
timoris	timoris
sed	sed
uirtutis	uirtutis
Et	Et
eccͥ	ecclesiasticus
xl	xl
uirtutes	uirtutes
exaltant	exaltant
cor	cor
.	.
Et	Et
hec	hec
pauca	pauca
de	de
prima	prima
p	p

detis	detis
secũda	secunda
pars	pars
antecedẽtis	antecedentis
que	que
est	est
s	sed
dux	dux
noster	noster
ĩclitus	inclitus
⁊	et
c̃	cetera
patet	patet
per	per
illd̃	illd
io	io
IN	IN
pͥncipio	principio
ẽat	erat
ũbũ	uerbum
et	et
ũbũ	uerbum
ẽat	erat
aput	aput
d̃m	deum

	et
deus	deus
ẽat	erat
ũbũ	uerbum
hoc	hoc
ẽat	erat
in	in
pͥncipio	principio
aput	aput
d̃m	deum
Om̃ia	Omnia
ꝑ	per
ip̃m	ipsum
fc̃a	facta
s̃t	sunt
	et
sine	sine
ipo	ipso
fc̃m	factum
÷	est
nichil	nichil
Qͦt	Quot
fc̃m	factum
÷	est
in	in

ipo	ipso
uita	uita
ẽat	erat
Et	Et
uita	uita
ẽat	erat
lux	lux
hoĩm	hominum
Et	Et
lux	lux
in	in
tenebͥs	tenebris
lucet	lucet
	et
tenebre	tenebre
eã	eam
non	non
ꝯhenderũt	comprehenderunt
fuit	fuit
homo	homo
missus	missus
a	a
deo	deo
cui	cui
nomẽ	nomen

ẽat	erat
iohãnes	iohannes
Hic	Hic
uenit	uenit
ĩ	in
testimõiͫ	testimonium
ut	ut
testimõͫ	testimonium
ꝑhib̃et	perhiberet
de	de
lumĩe	lumine
ut	ut
om̃es	omnes
cred̃ent	crederent
ꝑ	per
illũ	illum
Non	Non
ẽat	erat
ille	ille
lux	lux
s	sed
ut	ut
testimom	testimonium
ꝑhib̃et	perhiberet
de	de

lumĩe	lumine
Ẽat	Erat
lux	lux
ũa	uera
q̃	que
illuĩat	illuminat
om̃em	omnem
homĩem	hominem
uenientẽ	uenientem
in	in
hũc	hunc
mũdum	mundum
In	In
mundo	mundo
illum	illum
sed	sed
se	se
asidione	asidione
procreatum	procreatum
Verum	Verum
postꝙͣ	postquam
a	a
sillana	sillana
uiolencia	uiolencia
cesa	cesa

riana	riana
equitas	equitas
reduxit	reduxit
gubernacula	gubernacula
Romani	Romani
Imperii	Imperii
iustiore	iustiore
principe	principe
optinente	optinente
in	in
pubca	publica
custodia	custodia
sp̃um	spiritum
posuit	posuit
Eodem	Eodem
preside	preside
R.	Rei
pubce	publice
in	in
consiml̃i	consimili
mendacio	mendacio
muliebris	muliebris
temẽitas	temeritas
repressa	repressa
est	est

Siquidem	Siquidem
cum	cum
se	se
pro	pro
rubria	rubria
quedam	quedam
perinde	perinde
ac	ac
falso	falso
credita	credita
ess	esset
incendio	incendio
perpeti	perpeti
nichil	nichil
ad	ad
se	se
ꝑtinentib	pertinentibus
bonis	bonis
inser̃et	insereret
neq	neque
ei	ei
aut	aut
splendidi	splendidi
testes	testes
aut	aut

cohortis	cohortis
Augusti	Augusti
fauor	fauor
deess	deesset
propter	propter
inexpungnabl̃em	inexpungnabilem
Cesaris	Cesaris
constanciam	constanciam
irrita	irrita
propoĩti	propositi
nefarii	nefarii
abiit	abiit
Idem	Idem
barbarum	barbarum
quendam	quendam
propter	propter
eximiam	eximiam
sil̃itudi	similitudi
nem	nem
Capadocie	Capadocie
Regnum	Regnum
affectantem	affectantem
tamꝙͣ	tamquam
Ariathes	Ariathes
ess	esset

quem	quem
a	a
M	M
.	.
Antonio	Antonio
interemptum	interemptum
luce	luce
clarius	clarius
erat	erat
ꝙͣꝙͣ	quamquam
pene	pene
tocius	tocius
orientis	orientis
Ciuita	Ciuita
tium	tium
et	et
gentium	gentium
credula	credula
suffragacõne	suffragacione
fultum	fultum
caput	caput
dementer	dementer
Impẽio	Imperio
in	in
minens	minens

iusto	iusto
Impendi	Impendi
supplicio	supplicio
coegit	coegit
Explicit	Explicit
Ualerius	Ualerius
Maximus	Maximus
Anno	Anno
mͦ	mo
ccccmo	ccccmo
tercio	tercio
cͥca	circa
festũ	festum
assupͦͥᷤ	assumptiois
Maria	Maria
Fili	Fili
mandata	mandata
data	data
que	que
sunt	sunt
congrua	congrua
laudi	laudi
Incipit	Incipit
speculũ	speculum
sacerdotũ	sacerdotum

cclesie	cclesie
sancte	sancte
Regimẽ	Regimen
qui	qui
duc̃e	ducere
sancte	sancte
uis	uis
hec	hec
metra	metra
lege	lege
de	de
sc̃a	sancta
ꝯdita	condita
lege	lege
Que	Que
si	si
ꝑleg̃e	perlegere
bñ	bene
uis	uis
⁊	et
corde	corde
tenere	tenere
acti	acti
ꝯplere	complere
pot̃is	poteris

bona	bona
semꝑ	semper
habere	habere
hoc	hoc
speculũ	speculum
clarũ	clarum
curã	curam
mõstrans	monstrans
aĩarũ	animarum
Condo	Condo
tibi	tibi
carũ	carum
plusꝙͣ	plusquam
sit	sit
gẽma	gemma
uel	uel
aurũ	aurum
Quo	Quo
possis	possis
aĩas	animas
sacͣmẽt̃	sacramento
reddere	reddere
mũdas	mundas
Crimina	Crimina
uitare	uitare

regente	regente
primo	primo
tñ	tamen
dñm	dominum
rogo	rogo
trinũ	trinum
sẽꝑ	semper
⁊	et
unũ	unum
a	a
quo	quo
cũcta	cuncta
bona	bona
manãt	manant
ut	ut
det	det
michi	michi
dona	dona
Cũ	Cum
quib	quibus
hoc	hoc
speculũ	speculum
ualeã	ualeam
ꝯplere	complere
nouellũ	nouellum

utile	utile
mũdanis	mundanis
aĩabus	animabus
edificandis	edificandis
de	de
modo	modo
⁊	et
forma	forma
hui᷒	huius
libri	libri
De	De
titulo	titulo
pandã	pandam
tibi	tibi
primo	primo
ꝯmoda	commoda
quedã	quedam
ut	ut
ẜues	serues
uitã	uitam
post	post
hec	hec
dicetur	dicetur
honestam	honestam
Que	Que

debes	debes
scire	scire
faciã	faciam
post	post
ista	ista
subire	subire
hinc	hinc
ꝙ	quod
in	in
eccl̃a	ecclesia
residencia	residencia
sit	sit
facienda	facienda
Que	Que
sũt	sunt
officia	officia
tibi	tibi
subiũgã	subiungam
fugienda	fugienda
post	post
hec	hec
officia	officia
tibi	tibi
debita	debita
iũgo	iungo

nouena	nouena
Scilic	Scilicet
in	in
sacra	sacra
digne	digne
tractes	tractes
sac̃menta	sacramenta
ut	ut
missas	missas
celebres	celebres
deuote	deuote
post	post
ea	ea
cernes	cernes
postea	postea
monstratur	monstratur
quid	quid
quomodo	quomodo
ꝯfiteatur	confiteatur
Quomodo	Quomodo
doctrinã	doctrinam
tradas	tradas
transportati	transportati
eẽnt	essent
⁊	et

ea	preterea
suplem̃to	suplemento
adducto	adducto
quo	quo
ã	am
pli᷒	plius
duab.	duabus
legionib.	legionibus
ꝙͣ	quam
x	x
milia	milia
⁊	et
quadringẽti	quadringenti
pedi	pedi
tes	tes
sexcenti	sexcenti
eꝗtes	equites
eẽnt	essent
⁊	et
sociũ	socium
lat̃i	latini
noĩis	nominis
duodecĩ	duodecim
milia	milia
sexcẽti	sexcenti

eꝗtes	equites
quoꝝ	quorum
forti	forti
oꝑa	opera
adũsus	aduersus
celti	celti
beros	beros
liis	preliis
usus	usus
ꝗnt᷒	quintus
fului᷒	fuluius
eẽt	esset
quos	quos
si	si
uideret᷑	uideretur
secũ	secum
deportaret	deportaret
⁊	et
suplicatões	suplicationes
dec̃te	decrete
ꝙ	quod
is	is
ꝓspere	prospere
rem	rem
publicã	publicam

gesisset	gesisset
⁊	et
cet̃i	ceteri
tores	pretores
ĩ	in
ꝓuĩcias	prouincias
ꝗnto	quinto
fab	fab
io	io
butroni	butroni
ꝓrogatũ	prorogatum
in	in
galliã	galliam
imꝑiũ	imperium
ẽ	est
octo	octo
le	le
giones	giones
ter	preter
ex̃citũ	exercitum
uet̃em	ueterem
ꝗ	qui
ĩ	in
ligurib.	liguribus
ĩ	in

stabat	stabat
tor	pretor
tit᷒	titus
minuti᷒	minutius
⁊	et
haut	haut
ita	ita
ml̃to	multo
p᷒	post
ꝯsul	consul
gne᷒	gneus
calfurni᷒	calfurnius
morit᷑	moritur
ml̃tiq	multique
alii	alii
õiu	omnium
ordinũ	ordinum
illustres	illustres
uiri	uiri
post̃mo	postremo
ꝓdigii	prodigii
loco	loco
ea	ea
clades	clades
h̃ri	haberi

cepta	cepta
gne᷒	gneus
ẜuili᷒	seruilius
pontifex	pontifex
maxi᷒	maximus
piacula	piacula
ire	ire
deũ	deum
ꝯꝗr̃e	conquirere
iussi	iussi
x	x
uiri	uiri
libros	libros
in	in
spic̃e	spicere
ꝯsul	consul
apol̃i	apolini
exculapio	exculapio
salutis	salutis
dona	dona
uo	uo
uere	uere
⁊	et
dare	dare
signa	signa

ĩaurata	inaurata
q̃	que
uouit	uouit
dedit	dedit
q	que
x	x
uiri	uiri
suplicationẽ	suplicationem
ĩ	in
biduũ	biduum
ualitudinis	ualitudinis
c̃a	causa
⁊	et
ꝑ	per
õia	omnia
fora	fora
ꝯciliabulaq	conciliabulaque
edixerunt	edixerunt
NUnc	NUnc
itaq	itaque
quoniam	quoniam
principales	principales
errores	errores
nõ	non
habentiũ	habentium

legẽ	legem
in	in
pre	pre
missa	missa
hui᷒	huius
opusculi	opusculi
ꝑ	par
te	te
satis	satis
uidẽtur	uidentur
euersi	euersi
Ad	Ad
iugulandũ	iugulandum
errores	errores
legem	legem
habentiũ	habentium
Erit	Erit
ulterius	ulterius
insistendũ	insistendum
Porro	Porro
	quia
iudei	iudei
int̃	inter
legẽ	legem
h̃ntes	habentes

Primũ	Primum
sibi	sibi
arrogant	arrogant
locũ	locum
pͥmi	primi
ĩ	in
hac	hac
ẜa	secunda
parte	parte
aggrediẽdi	aggrediendi
sunt	sunt
Sciendum	Sciendum
igit᷑	igitur
Q̃d	Quod
iudeis	iudeis
scissura	scissura
decẽ	decem
tribuũ	tribuum
hoc	hoc
nom̃	nomen
inposuit	inposuit
Antea	Antea
quippe	quippe
hebrei	hebrei
ul̃	ue

ysrael	ysrael
di	di
cebãtur	cebantur
Ex	Ex
quo	quo
autẽ	autem
in	in
duo	duo
regna	regna
populus	populus
ille	ille
diuisus	diuisus
est	est
Quicũq	Quicunque
ex	ex
eis	eis
reges	reges
habu	habu
erũt	erunt
de	de
stirpe	stirpe
iude	iude
seu	seu
de	de
tribu	tribu

iuda	iuda
Iudei	Iudei
d	d
dicti	dicti
sũt	sunt
Decem	Decem
uõ	uero
trib.	tribus
et	et
quicũq	quicunque
in	in
sama	sama
ria	ria
Ihẽoboam	Iheroboam
regẽ	regem
sibi	sibi
constituerũt	constituerunt
Israel	Israel
i	i
sunt	sunt
uocati	uocati
Quib.	Quibus
yeroboã	yeroboam
duos	duos
uitulos	uitulos

au	au
reos	reos
fatiẽs	fatiens
Unũ	Unum
posuit	posuit
in	in
dan	dan
et	et
alteꝝ	alterum
in	in
be	be
thel	thel
Dixitq	Dixitque
eis	eis
regnũ	regnum
telorũ	telorum
Sed	Sed
tamen	tamen
dc̃i	dicti
Iudei	Iudei
expectauerunt	expectauerunt
⁊	et
credi	credi
derunt	derunt
uenturũ	uenturum

sicut	sicut
patres	patres
eorũ	eorum
antiqui	antiqui
crediderũt	crediderunt
Et	Et
tñ	tamen
in	in
inferno	inferno
fuerũt	fuerunt
Et	Et
qui	qui
si	si
uixissent	uixissent
usq	usque
ad	ad
tempus	tempus
aduentus	aduentus
ꝓphete	prophete
xp̃i	Christi
tãtũ	tantum
credidissent	credidissent
ipi	ipsi
xp̃m	Christum
quã	quan

tum	tum
et	et
isti	isti
crediderũt	crediderunt
Cũ	Cum
xp̃s	Christus
ꝓph̃ã	prophetam
aggrauare	aggrauare
debe	debe
bat	bat
corda	corda
Iudeorũ	Iudeorum
et	et
eorũ	eorum
oculos	oculos
excecare	excecare
et	et
aures	aures
claudere	claudere
ut	ut
ysa.	ysaias
vi	vi
Et	Et
per	per
consequens	consequens

credere	credere
non	non
poterant	poterant
ut	ut
Io.	Iohannes
xii	xii
Nonne	Nonne
antiqui	antiqui
pr̃es	patres
eorũ	eorum
ĩterfecer̃t	interfecerint
sanctos	sanctos
ꝓph̃as	prophetas
etiã	etiam
a	a
deo	deo
missos	missos
sicut	sicut
ysayam	ysayam
et	et
Ieremiã	Ieremiam
et	et
alios	alios
ꝙͣ	quam
plures	plures

sed	sed
tñ	tamen
dicti	dicti
antiqui	antiqui
et	et
sancti	sancti
patres	patres
in	in
inferno	inferno
dãpnati	dampnati
fuerunt	fuerunt
in	in
sanguĩe	sanguine
testam̃ti	testamenti
saluati	saluati
de	de
inferno	inferno
ergo	ergo
et	et
isti	isti
Dicite	Dicite
michi	michi
o	o
Iusticia	Iusticia
quid	quid

habuit	habuit
significare	significare
de	de
latere	latere
xp̃i	Christi
iudicis	iudicis
nostri	nostri
sanguĩem	sanguinem
et	et
clarã	claram
aquam	aquam
emanasse	emanasse
Ait	Ait
Iusticia	Iusticia
nescio	nescio
Ait	Ait
misericordia	misericordia
Postꝙͣ	Postquam
nescis	nescis
te	te
docebo	docebo
Et	Et
ait	ait
ipa	ipsa
sãguĩe	sanguine

ille	ille
fuit	fuit
sanguis	sanguis
federis	federis
de	de
quo	quo
supͣdc̃m	supradictum
est	est
In	In
quo	quo
san	san
guĩe	guine
om̃es	omnes
circũcisos	circumcisos
non	non
preuaricatores	preuaricatores
legis	legis
et	et
adeo	adeo
et	et
legis	legis
non	non
fornicatores	fornicatores
educere	educere
debebat	debebat

de	de
inferno	inferno
Aqua	Aqua
illa	illa
fuit	fuit
federis	federis
gentiũ	gentium
populi	populi
In	In
qua	qua
aqua	aqua
ipe	ipse
dc̃as	dictas
gentes	gentes
in	in
ppl̃m	populum
et	et
regnum	regnum
debebat	debebat
hereditare	hereditare
ut	ut
ysaye	ysaye
lii	lii
Sic	Sic
ingloriosus	ingloriosus

erit	erit
inter	inter
uiros	uiros
aspectus	aspectus
et	et
forma	forma
eius	eius
inter	inter
filios	filios
hoĩm	hominum
ipe	ipse
asꝑget	asperget
gentes	gentes
multas	multas
suꝑ	super
ip̃m	ipsum
cõti	conti
nebunt᷑	nebuntur
reges	reges
os	os
suũ	suum
quia	quia
quib᷒	quibus
non	non
est	est

narratũ	narratum
non	non
de	de
eo	eo
uidebunt	uidebunt
et	et
qui	qui
non	non
audierunt	audierunt
contemplati	contemplati
sunt	sunt
et	et
etiã	etiam
ipe	ipse
xp̃s	Christus
qui	qui
debuit	debuit
expͥmi	exprimi
cũ	cum
semper	semper
inter	inter
istos	istos
duos	duos
populos	populos
fũit	fuerit

aquis	aquis
uiuentib	uiuentibus
aspergebat	aspergebat
leprosũ	leprosum
et	et
mũda	munda
batur	batur
Ita	Ita
xp̃e	Christe
legis	legis
sacerdos	sacerdos
aspergens	aspergens
de	de
suo	suo
latere	latere
sanguĩem	sanguinem
⁊	et
aquã	aquam
uiuam	uiuam
mũdũ	mundum
leꝓsũ	leprosum
in	in
pc̃tis	peccatis
mũdauit	mundauit
⁊	et

mũdabit	mundabit
As	As
illus	illus
quos	quos
dicis	dicis
de	de
tribus	tribus
sceleribus	sceleribus
et	et
de	de
quarto	quarto
⁊c̃	etcetera
Tu	Tu
Iusticia	Iusticia
debes	debes
scire	scire
te	te
Oratio	Oratio
sancti	sancti
ambrosii	ambrosii
que	que
debet	debet
dici	dici
ante	ante
missam	missam

Summe	Summe
sacerdos	sacerdos
et	et
uere	uere
pontifex	pontifex
qui	qui
te	te
obtulisti	obtulisti
deo	deo
patri	patri
hostiam	hostiam
puram	puram
et	et
immaculatam	immaculatam
in	in
ara	ara
crucis	crucis
pro	pro
nobis	nobis
miseris	miseris
pcc̃oribus	peccatoribus
quiq	quique
dedisti	dedisti
nobis	nobis
carnem	carnem

tuam	tuam
ad	ad
manducandum	manducandum
et	et
sanguinem	sanguinem
tuũ	tuum
ad	ad
biben	biben
dum	dum
et	et
posuisti	posuisti
misterium	misterium
istud	istud
in	in
uirtute	uirtute
spiritus	spiritus
sãcti	sancti
dicens	dicens
hec	hec
quocienscũq	quocienscunque
fe	fe
ceritis	ceritis
in	in
mei	mei
memoriam	memoriam

fa	fa
Nec	Nec
letheos	letheos
seua	seua
per	per
amnes	amnes
Uos	Uos
fata	fata
trahent	trahent
sed	sed
cũ	cum
sũmas	summas
Exiget	Exiget
horas	horas
consumpta	consumpta
dies	dies
Iter	Iter
ad	ad
superos	superos
gl̃ia	gloria
pandet	pandet
Sed	Sed
tu	tu
domitor	domitor
magne	magne

feraꝝ	ferarum
Orbisq	Orbisque
siml̃	simul
pacator	pacator
ades	ades
Nũc	Nunc
quoq	quoque
nr̃as	nostras
respice	respice
terras	terras
Et	Et
si	si
qua	qua
noua	noua
belua	belua
uultu	uultu
Quatiet	Quatiet
ppl̃os	populos
terrore	terrore
graui	graui
Tu	Tu
fulminib.	fulminibus
frange	frange
trisulcis	trisulcis
Fortius	Fortius

ipo	ipso
genitore	genitore
tuo	tuo
Fulmina	Fulmina
mittes	mittes
Expliciunt	Expliciunt
Tragedie	Tragedie
Senece	Senece
Deo	Deo
Gracias	Gracias
Amen	Amen
Scripte	Scripte
ac	ac
con	con
plete	plete
per	per
manus	manus
Iohãnis	Iohannis
Ten	Ten
Norde	Norde
de	de
Doetinchem	Doetinchem
Clerici	Clerici
Traiecteñ	Traiectensis
dyoc̃	dyocesis

Sub	Sub
Anno	Anno
dñi	domini
Mͦ	Mo
ccccͦ	cccco
viiii	viiii
Die	Die
decimanona	decimanona
Mensis	Mensis
Ianuarii	Ianuarii
Epitaphiu	Epitaphium
Senece	Senece
Cura	Cura
labor	labor
meritu	meritum
sũpti	sumpti
ꝓ	pro
munere	munere
honores	honores
Ite	Ite
alias	alias
post	post
hanc	hanc
solicitate	solicitate
animas	animas

Me	Me
procul	procul
a	a
uob̃	uobis
deus	deus
euocat	euocat
ilicet	ilicet
actis	actis
Rebus	Rebus
terrenis	terrenis
hospita	hospita
terra	terra
uale	uale
Corpus	Corpus
auara	auara
tñ	tamen
solẽpnib.	solempnibus
accipe	accipe
saxis	saxis
Namq	Namque
aĩam	animam
celo	celo
reddim᷒	reddimus
ossa	ossa
tibi	tibi

Expliciunt	Expliciunt
uocabula	uocabula
ugucionis	ugucionis
incipientia	incipientia
a	a
Z	Z
Xplicit	Xplicit
Expositio	Expositio
uocabulorum	uocabulorum
ex	ex
sententia	sententia
ugutionis	ugutionis
ꝯ	com
pilacione	pilacione
Iacobi	Iacobi
ꝯdam	condam
Mag̃ri	Magistri
Isaac	Isaac
phisici	phisici
de	de
padua	padua
com	com
pleta	pleta
clugie	clugie
Anno	Anno

xp̃i	Christi
Mcccxxiii	Mcccxxiii
de	de
ms̃	mense
nouembris	nouembris
Et	Et
scripta	scripta
ꝑ	per
me	me
Iohannem	Iohannem
ꝯdam	condam
d̃	domin
Siluestri	Siluestri
de	de
luxa	luxa
ueneciaru	ueneciarum
originariu	originarium
⁊	et
teruisii	teruisii
ciuem	ciuem
publicum	publicum
Imperiali	Imperiali
Auct̃e	Auctoritatee
notarium	notarium
⁊	et

tũc	tunc
Cancelarium	Cancelarium
Magnifici	Magnifici
⁊	et
potentis	potentis
dñi	domini
dñi	domini
Nicolai	Nicolai
Mudatio	Mudatio
pro	pro
ẜenisimo	Serenisimo
⁊	et
excellentissimo	excellentissimo
ducali	ducali
dñio	dominio
veneciaꝝ	veneciarum
tocius	tocius
Insule	Insule
crete	crete
honorabilis	honorabilis
capitañ	capitanei
generalis	generalis
⁊	et
Completa	Completa
In	In

ciuitate	ciuitate
candide	candide
Anno	Anno
natiuitatis	natiuitatis
dñi	domini
nr̃i	nostri
ih̃u	iesu
xp̃i	Christi
Mccccxii	Mccccxii
Indic̃	Indictione
quĩta	quinta
die	die
Sabati	Sabati
xvii	xvii
mensis	mensis
decembris	decembris
ciosa	ciosa
qualia	qualia
sunt	sunt
õia	omnia
signa	signa
mortẽ	mortem
ꝓnosticia	pronosticancia
Que	Que
uõ	uero

in	in
parte	parte
auferũt	auferunt
uel	uel
auferri	auferri
sig	sig
nificant	nificant
ut	ut
signa	signa
nũciãtia	prenunciantia
torturã	torturam
uel	uel
ꝑalisim	paralisim
aut	aut
appoͣ̃	appoplexiam
uel	uel
cardiacã	cardiacam
aͭ	aut
sil̃ia	similia
pessima	pessima
quidẽ	quidem
sunt	sunt
s	sed
mĩoris	minoris
malicie	malicie

ꝙͣ	quam
illa	illa
que	que
cise	precise
mortẽ	mortem
ꝓnosticãt	pronosticant
De	De
qͥb	quibus
om̃ib	omnibus
spãlr̃	specialiter
ꝑtractãe	pertractare
nõ	non
spectat	spectat
intͦduconum	introductionum
pñtiũ	presentium
forme	forme
siue	siue
tenori	tenori
s	sed
predc̃is	predictis
ꝯtenti	contenti
gr̃as	gratias
r̃ferim	referimus
dño	domino
ih̃u	iesu

xp̃o	Christo
qͥ	qui
ꝯsid̃acões	consideraciones
intͦductorias	introductorias
pͥme	prime
partis	partis
mene	medicine
que	que
theo	theo
rica	rica
dr̃d	dicitur
adimpleuit	adimpleuit
Et	Et
qui	qui
iã	iam
in	in
r̃giͭͦ	regimento
sa	sa
nitatis	nitatis
nr̃o	nostro
⁊	et
affomis	afforismis
de	de
Ingenio	Ingenio
sanitatis	sanitatis

h̃undanter	habundanter
inchoauit	inchoauit
consid̃acões	consideraciones
pratice	pratice
necc̃as	neccessarias
⁊	et
sꝑam	speramus
cũ	cum
deuocõe	deuocione
ꝙ	quod
ipe	ipse
ꝑficiet	perficiet
in	in
ꝯto	comento
dc̃oꝝ	dictorum
affoꝝ	afforismorum
⁊	et
in	in
aliis	aliis
affomis	afforismis
ꝑticuter	particulariter
expͥmentib	exprimentibus
que	que
per	per
medicũ	medicum

sapientem	sapientem
consid̃anda	consideranda
sunt	sunt
in	in
morbis	morbis
quoꝝdã	quorumdam
m̃bro	membro
rum	rum
ꝑticurium	particularium
in	in
quib	quibus
uelut	uelut
in	in
exemplo	exemplo
siue	siue
speculo	speculo
claro	claro
uia	uia
rc̃	recti
ꝓcessus	processus
in	in
cetẽis	ceteris
aꝑtissime	apertissime
cognoscaͬ	cognoscatur
a	a

cũctis	cunctis
amatõibus	amatoribus
ũitatis	ueritatis
ducentum	ducentum
paruulos	paruulos
ad	ad
uiam	uiam
que	que
ducit	ducit
ad	ad
xp̃m	Christum
Qui	Qui
conuerti	conuerti
fecerit	fecerit
peccatorem	peccatorem
ab	ab
errore	errore
uie	uie
sue	sue
saluabit	saluabit
aĩam	animam
eius	eius
a	a
morte	morte
et	et

operit	operit
multitudinem	multitudinem
peccatorum	peccatorum
Ex	Ex
hoc	hoc
uerbo	uerbo
trahere	trahere
potuit	potuit
gregorius	gregorius
nullum	nullum
esse	esse
deo	deo
accepcius	accepcius
sa	sa
crificium	crificium
ꝙͣ	quam
zelum	zelum
animarum	animarum
ꝙ	quod
si	si
tanta	tanta
sollicitu	sollicitu
dinis	dinis
inquietudine	inquietudine
si	si

sarcinulas	sarcinulas
quas	quas
apostolus	apostolus
arbitrabatur	arbitrabatur
ut	ut
stercora	stercora
Et	Et
dum	dum
hec	hec
agunt	agunt
laudantur	laudantur
ut	ut
industrii	industrii
ut	ut
diligẽ	diligen
tes	tes
ut	ut
officiosi	officiosi
et	et
utiles	utiles
rei	rei
publice	publice
Uidete	Uidete
oro	oro
quanta	quanta

est	est
uel	uel
inhercia	inhercia
uel	uel
infidelitas	infidelitas
de	de
ani	ani
marum	marum
ĩmortalium	immortalium
salute	salute
non	non
curare	curare
xp̃ianos	Christianos
ymo	ymo
qualis	qualis
illa	illa
est	est
impudentissima	impudentissima
peruersi	peruersi
tas	tas
eos	eos
inculpare	inculpare
Dñs	Dominus
q	que
nunc	nunc

apertis	apertis
nunc	nunc
occultis	occultis
prepedire	prepedire
qui	qui
ducere	ducere
paruulos	paruulos
satagũt	satagunt
aiat	aiat
Ardis	Ardis
Tanta	Tanta
ardebat	ardebat
cura	cura
ut	ut
architecto	architecto
permiserit	permiserit
uel	uel
ut	ut
suã	suam
pecuniam	pecuniam
consumeret	consumeret
dũmodo	dummodo
perduceret	perduceret
specus	specus
e	e

pistrinis	pistrinis
in	in
mare	mare
abiecta	abiecta
mole	mole
qua	qua
estus	estus
bis	bis
quotidie	quotidie
ab	ab
ex	ex
orͭa	orta
luna	luna
ad	ad
proximũ	proximum
nouã	nouam
introire	introire
ac	ac
redire	redire
rursus	rursus
in	in
ma	ma
re	re
posset	posset
ac	ac

refrigerare	refrigerare
piscinas	piscinas
Nos	Nos
cum	cum
hęc	hęc
&	et
ecce	ecce
stre	stre
pitus	pitus
destra	destra
atq.	atque
leua	leua
candidatus	candidatus
noster	noster
designatus	designatus
Ędilis	Ędilis
adest	adest
ad	ad
uillã	uillam
Cui	Cui
nos	nos
occidimus	occidimus
&	et
gratulati	gratulati
ĩ	in

Capitoliũ	Capitolium
persequimur	persequimur
Illo	Illo
inde	inde
cuncto	cuncto
suã	suam
domũ	domum
nos	nos
nostrã	nostram
Oppi	Oppi
nioni	nioni
nostro	nostro
sermone	sermone
de	de
pastione	pastione
uillatica	uillatica
sumatim	sumatim
hoc	hoc
quẽ	quem
exposui	exposui
habito	habito
M	M
Terrencii	Terrencii
Uarronis	Uarronis
rerũ	rerum

rustica	rustica
rum	rum
de	de
uillaticis	uillaticis
pastionibus	pastionibus
liber	liber
tercius	tercius
explicit	explicit
fe	fe
liciter	liciter
1414	1414
M	M
T	T
C	C
EPISTOLARŨ	EPISTOLARUm
AD	AD
ATTICŨ	ATTICUm
L	L
XIII	XIII
IN	IN
CIPIT	CIPIT
FELICITER	FELICITER
CICERO	CICERO
attico	attico
sal.	salutem

Ad	Ad
ciceronem	ciceronem
ita	ita
scripsisti	scripsisti
ut	ut
neq	neque
seuerius	seuerius
neq	neque
temperatius	temperatius
scribi	scribi
potuerit	potuerit
nec	nec
magis	magis
ꝙͣ	quam
quẽad	quemad
o	o
modũ	modum
ego	ego
maxime	maxime
uellem	uellem
prudentissime	prudentissime
et̃	etiam
ad	ad
tullios	tullios
quare	quare

aut	aut
ista	ista
pro	pro
ficient	ficient
aut	aut
aliud	aliud
agamus	agamus
De	De
pecunia	pecunia
uͦ	uero
uideo	uideo
a	a
te	te
omnẽ	omnem
diligentiam	diligentiam
adhiberi	adhiberi
uel	uel
potius	potius
iam	iam
adhibitã	adhibitam
esse	esse
efficis	efficis
a	a
te	te
hortos	hortos

habeo	habeo
nec	nec
uͦ	uero
ul	ul
lum	lum
genus	genus
possessionis	possessionis
est	est
quod	quod
malim	malim
maxi	maxi
me	me
scilicet	scilicet
ob	ob
eam	eam
causam	causam
quae	quae
suscepta	suscepta
est	est
cu	cu
ius	ius
festinatione	festinatione
mihi	mihi
tollis	tollis
qm̃	quoniam

de	de
estate	estate
pol	pol
liceris	liceris
uel	uel
potius	potius
recipis	recipis
deinde	deinde
et̃	etiam
ad	ad
καταβί	καταβί
uitã	uitam
Marci	Marci
Tullii	Tullii
Ciceronis	Ciceronis
contra	contra
Catilinam	Catilinam
Oraciones	Oraciones
iiiior	iiiior
Quo	Quo
usq	usque
tandem	tandem
abut̃e	abutere
catilina	catilina
pac̃ia	paciencia

chil	chil
timores	timores
ppl̃i	populi
nichil	nichil
concursus	concursus
bonoꝝ	bonorum
oĩm	omnium
nichil	nichil
hic	hic
munitissim᷒	munitissimus
habendi	habendi
senatus	senatus
loc᷒	locus
nich̃	nichil
hoꝝ	horum
ora	ora
uultusq	uultusque
mouerũt	mouerunt
Patere	Patere
tua	tua
consi	consi
lia	lia
non	non
sentis	sentis
Constrictã	Constrictam

iam	iam
hoꝝ	horum
omniũ	omnium
sciencia	sciencia
teneri	teneri
coniuracionẽ	coniuracionem
tuã	tuam
nõ	non
uides	uides
Qͥd	Quid
ꝓxima	proxima
quid	quid
superiori	superiori
nocte	nocte
egeris	egeris
ubi	ubi
fueris	fueris
quid	quid
consilii	consilii
ceperis	ceperis
quos	quos
cõuocaueris	conuocaueris
quẽ	quem
nr̃m	nostrum
ignorare	ignorare

arbitraris	arbitraris
O	O
tp̃ra	tempora
o	o
mores	mores
senat᷒	senatus
hoc	hoc
intelligit	intelligit
consul	consul
uidet	uidet
hic	hic
tamen	tamen
uiuit	uiuit
uiuit	uiuit
Immo	Immo
uero	uero
in	in
senatũ	senatum
uenit	uenit
fit	fit
publici	publici
cõsilii	consilii
par	par
ticeps	ticeps
Notat	Notat

⁊	et
designat	designat
oculis	oculis
ad	ad
cedẽ	cedem
unũqͤnq	unumquenque
nr̃m	nostrum
Nos	Nos
autẽ	autem
fortes	fortes
uiri	uiri
satisfac̃e	satisfacere
rei	rei
publice	publice
ui	ui
dem᷑	demur
si	si
istius	istius
tela	tela
ac	ac
furorem	furorem
uitem᷒	uitemus
Ad	Ad
mortem	mortem
te	te

catilina	catilina
duci	duci
iussu	iussu
consulis	consulis
iã	iam
pͥdem	pridem
oportebat	oportebat
In	In
te	te
cõferri	conferri
pestem	pestem
istam	istam
ꝙͣ	quam
tu	tu
ĩ	in
nos	nos
om̃s	omnes
iã	iam
ma	ma
chinaris	chinaris
An	An
uero	uero
uir	uir
amplissim᷒	amplissimus
p	p

scipio	scipio
põtifex	pontifex
maxim᷒	maximus
tiberinũ	tiberinum
gracchũ	gracchum
mediocriter	mediocriter
labefactãte	labefactante
statũ	statum
r.	rei
pae	publicae
pͥuatus	priuatus
interfecit	interfecit
Catilina	Catilina
uero	uero
orbem	orbem
terre	terre
cede	cede
atq	atque
incendiͦ	incendio
uastare	uastare
cupientẽ	cupientem
nos	nos
ꝯsules	consules
perferem᷒	perferemus
Nam	Nam

illa	illa
nimis	nimis
antiqͣ	antiqua
pret̃eo	pretereo
q̃dq	quodque
ser	ser
caderet	caderet
Uoluit	Uoluit
enĩ	enim
in	in
excelsum	excelsum
leuari	leuari
ad	ad
co	co
niũ	nium
ut	ut
ruente	ruente
illũ	illum
de	de
excelso	excelso
oculi	oculi
om̃iũ	omnium
ꝑui	perui
gitur	gitur
est	est

s	s
mina	mina
fidelium	fidelium
incitam̃ta	incitamenta
sunt	sunt
e	e
Armantur	Armantur
enĩ	enim
filioꝝ	filiorum
animi	animi
dũ	dum
p	p
tur	tur
triumphi	triumphi
Clamat	Clamat
utiq	utique
xp̃ianoꝝ	Christianorum
cor	cor
pioꝝ	piorum
sanguis	sanguis
sp̃ualiũ	spiritualium
bellatoꝝ	bellatorum
qͣntũ	quantum
amar	amar
tria	tria

hec	hec
Maior	Maior
aũ	autem
his	his
est	est
caritas	caritas
xiiii	xiiii
Sectamini	Sectamini
caritatẽ	caritatem
Emulamini	Emulamini
sp̃ualia	spiritualia
magis	magis
autẽ	autem
ut	ut
ꝓph̃etis	prophetetis
Qͥ	Qui
enĩ	enim
loquitur	loquitur
lingua	lingua
nõ	non
hõib	hominibus
loquit᷑	loquitur
sed	sed
deo	deo
Nemo	Nemo

enĩ	enim
audit	audit
Sp̃s	Spiritus
aũ	autem
loquitur	loquitur
myst̃ia	mysteria
Nã	Nam
qui	qui
ꝓph̃at	prophetat
hõib	hominibus
loquitur	loquitur
ad	ad
edificatõem	edificationem
et	et
exhortatõem	exhortationem
et	et
con	con
solationẽ	solationem
Qͥ	Qui
loquitur	loquitur
lingua	lingua
semet	semet
ip̃m	ipsum
edificat	edificat
Qͥ	Qui

autem	autem
ꝓph̃at	prophetat
eccl̃am	ecclesiam
dei	dei
edificat	edificat
Uolo	Uolo
aũ	autem
uos	uos
om̃s	omnes
loqui	loqui
linguis	linguis
magis	magis
aũ	autem
proph̃are	prophetare
Nam	Nam
maior	maior
est	est
qui	qui
proph̃at	prophetat
quã	quam
qui	qui
loqui	loqui
tur	tur
lingua	lingua
nisi	nisi

forte	forte
intertetur	interpretetur
ut	ut
eccl̃a	ecclesia
edificatõem	edificationem
accip	accip
at	at
Nunc	Nunc
aũ	autem
fr̃es	fratres
si	si
ueño	uenero
ad	ad
uos	uos
linguis	linguis
loquens	loquens
quid	quid
uo	uo
ꝓdero	prodero
nisi	nisi
uobis	uobis
loquar	loquar
aut	aut
in	in
reuelatõe	reuelatione

aut	aut
in	in
scĩa	scientia
au	au
men	men
et	et
illesũ	illesum
ĩuẽit	inuenit
Gesta	Gesta
ãt	autem
hui	huius
sc̃i	sancti
iulia	iulia
ni	ni
ad	ad
integrũ	integrum
habere	habere
neqͥuim	nequiuimus
ad	ad
manũ	manum
SC̃e	SanCte
brigide	brigide
uirg̃is	uirginis
kl̃is	kalendis
febroarii	febroarii

ex	ex
gestis	gestis
eius	eius
BEata	BEata
brigida	brigida
orta	orta
fuit	fuit
ĩ	in
sco	sco
cia	cia
de	de
bona	bona
ꝓsapia	prosapia
ex	ex
patre	patre
dubtocho	dubtocho
	et
matre	matre
broca	broca
ꝓge	proge
hec	hec
a	a
sua	sua
puericia	puericia
bonaꝝ	bonarum

rerum	rerum
studiis	studiis
inoleuit	inoleuit
pudicicie	pudicicie
ac	ac
sobri	sobri
etati	etati
intenta	intenta
semꝑ	semper
de	de
bonis	bonis
ad	ad
meliora	meliora
crescebat	crescebat
et	et
ab	ab
ipa	ipsa
puellari	puellari
etate	etate
uirtutũ	uirtutum
signis	signis
extitit	extitit
admiranda	admiranda
Cũ	Cum
enĩ	enim

a	a
ma	ma
tre	tre
sua	sua
trãsmissa	transmissa
eẽt	esset
ut	ut
de	de
uaccaꝝ	uaccarum
lacte	lacte
bu	bu
tirum	tirum
cõgregaret	congregaret
et	et
ad	ad
pondus	pondus
redderet	redderet
si	si
cut	cut
alie	alie
puelle	puelle
ĩ	in
illis	illis
regionib	regionibus
fac̃e	facere

solebãt	solebant
hec	hec
iam	iam
tũc	tunc
uirgo	uirgo
hospitalis	hospitalis
magis	magis
uolẽs	uolens
obedire	obedire
deo	deo
ꝙͣ	quam
hõib	hominibus
pauꝑib	pauperibus
	et
hospitib᷒	hospitibus
tam	tam
lac	lac
ꝙͣ	quam
butirum	butirum
largit᷑	largitur
distribuere	distribuere
cepit	cepit
Et	Et
cum	cum
tp̃s	tempus

aduenisset	aduenisset
ut	ut
om̃s	omnes
redderent	redderent
fruc	fruc
tum	tum
uaccaꝝ	uaccarum
cooꝑatrices	cooperatrices
eius	eius
monstraue	monstraue
runt	runt
oꝑa	opera
sua	sua
cõpleta	completa
Uentum	Uentum
est	est
ad	ad
bri	bri
gidam	gidam
ut	ut
redderet	redderet
opus	opus
suũ	suum
Que	Que
non	non

Romane	Romane
ac	ac
uni	uni
uersalis	uersalis
ecce	ecclesie
sũmi	summi
pontificis	pontificis
xii	xii
anno	anno
t̃cio	tercio
apd̃	apd
monaste	monaste
rium	rium
sancti	sancti
petͥ	petri
de	de
cult᷑a	cultura
cenom̃	cenomanensis
ordinis	ordinis
sancti	sancti
bñdicti	benedicti
capitulo	capitulo
ꝓuinciali	prouinciali
Allatum	Allatum
monast̃ioꝝ	monasteriorum

d̃i	dei
gr̃a	gratia
maioris	maioris
moͣst̃ii	monasterii
turoñ	turonensis
et	et
sancti	sancti
florencii	florencii
de	de
salmuro	salmuro
aude	aude
gaueñ	gauensis
dioc̃	diocesis
ad	ad
id	id
ꝑ	per
sedem	sedem
apl̃icam	apostolicam
specialr̃	specialiter
deputatoꝝ	deputatorum
ab	ab
Agnelli	Agnelli
debent	debent
immolari	immolari
quia	quia

agnus	agnus
futurus	futurus
ẽ	est
crucifigi	crucifigi
qui	qui
tollit	tollit
pcc̃a	peccata
mundi	mundi
S	Sed
oues	oues
ululãt	ululant
mr̃es	matres
quia	quia
agnos	agnos
ꝑdunt	perdunt
sñ	sine
uoce	uoce
balantes	balantes
Gran	Gran
de	de
martiriũ	martirium
crudele	crudele
spectaculũ	spectaculum
lc̃	lectio
vͣ	va

Eximitur	Eximitur
machera	machera
	et
nulla	nulla
int̃uenͭ	interuenit
c̃a	causa
Sola	Sola
stridet	stridet
inuidia	inuidia
cũ	cum
qui	qui
natus	natus
ẽ	est
nulli	nulli
faciat	faciat
uiolenciã	uiolenciam
S	Sed
oues	oues
cerni	cerni
mus	mus
mr̃es	matres
que	que
suꝑant	superant
agnos	agnos
lugentes	lugentes

Uox	Uox
in	in
ra	ra
ma	ma
audita	audita
ẽ	est
ploratus	ploratus
	et
ululatus	ululatus
magnus	magnus
pigno	pigno
ra	ra
sunt	sunt
nõ	non
credita	credita
sed	sed
creata	creata
nõ	non
deposita	deposita
sed	sed
expo	expo
sita	sita
testis	testis
ẽ	est
ipa	ipsa

n᷑a	natura
que	que
pugnabat	pugnabat
in	in
mr̃es	martires
cũ	cum
ty	ty
rãn᷒	rannus
iactaret	iactaret
ĩfãtes	infantes
lc̃	lectio
vͣ	va
Mater	Mater
crines	crines
capitis	capitis
dissipabat	dissipabat
que	que
ornamentũ	ornamentum
capitis	capitis
amͭtebat	amittebat
Quantis	Quantis
modis	modis
infantẽ	infantem
uolebat	uolebat
abscondere	abscondere

	et
ipe	ipse
se	se
infantulus	infantulus
publicabat	publicabat
Nesciebat	Nesciebat
tac̃e	tacere
,	,
quia	quia
ciam	ciam
in	in
eternu	eternu
Amen	Amen
Amen	Amen
Explicit	Explicit
or̃o	oratio
sc̃i	sancti
ambrosii	ambrosii
que	que
dicit᷑	dicitur
ante	ante
missam	missam
Orate	Orate
pro	pro
henrico	henrico

pauꝑe	paupere
clerico	clerico
qui	qui
cõpleuit	compleuit
hũc	hunc
librum	librum
Anno	Anno
dñi	domini
Mͦ	Mo
cccͦ	ccco
xlͦ	xlo
viiiͦ	viiio
In	In
crastino	crastino
fe	fe
sti	sti
bt̃i	beati
martini	martini
hyemalis	hyemalis
Pro	Pro
dño	domino
ludowico	ludowico
decano	decano
metñ	metensis
eccl̃ie	ecclesie

rigritaꝝ	rigritarum
Getuloꝝq	Getulorumque
passim	passim
uagantium	uagantium
Ne	Ne
littora	littora
ꝗ	qui
infe	infe
cunda	cunda
s̃t	sunt
p᷑pura	purpura
&	et
murice	murice
efficass̃is	efficacissimis
ad	ad
tingendum	tingendum
&	et
ubiq	ubique
q̃	que
ĩtinxere	intinxere
clarissima	clarissima
Reliqͣ	Reliqua
est	est
ora	ora
mauritanię	mauritanię

ext̃ior	exterior
&	et
ĩ	in
finẽ	finem
sui	sui
fastigãtis	fastigantis
se	se
africę	africę
nouissimus	nouissimus
angulus	angulus
iisdem	iisdem
opibus	opibus
s	sed
minus	minus
diues	diues
Cęt̃um	Cęterum
solo	solo
ditiõ	ditior
&	et
ad̃o	adeo
est	est
fertilis	fertilis
ut	ut
frugũ	frugum
gña	genera

nõ	non
cũ	cum
serant᷑	serantur
modo	modo
be	be
nignissime	nignissime
ꝓcreet	procreet
s	sed
q̃dam	quedam
ꝓfũdat	profundat
&̃	etiam
nota	nota
hic	hic
An	An
theus	theus
regnasse	regnasse
dicit᷑	dicitur
Et	Et
signũ	signum
q̃d	quod
fabulę	fabulę
prorsus	prorsus
õn	osten
ditur	ditur
claꝝ	clarum

collis	collis
modicus	modicus
resupini	resupini
hõis	hominis
imagĩe	imagine
iacẽtis	iacentis
illius	illius
ut	ut
ĩcolę	incolę
ferũt	ferunt
tumulus	tumulus
Unde	Unde
uͥ	ubi
aliqͣ	aliqua
ꝑs	pars
erupta	erupta
est	est
solent	solent
imbres	imbres
sꝑgi	spargi
&	et
donec	donec
effossa	effossa
repleant᷑	repleantur
euẽiunt	eueniunt

hoĩum	hominum
ꝑs	pars
siluas	siluas
freq̃ntãt	frequentant
minus	minus
ꝙͣ	quam
quos	quos
m̃o	modo
diximus	diximus
ua	ua
gi	gi
ꝑs	pars
ĩ	in
urbibus	urbibus
agũt	agunt
qͣꝝ	quarum
ut	ut
ĩt̃	inter
ꝑuas	paruas
opulẽtissimę	opulentissimę
h̃nt᷑	habentur
procul	procul
a	a
mari	mari
Gilodano	Gilodano

ꝓmontoriũ	promontorium
oꝑis	operis
huius	huius
at	atque
atlantici	atlantici
littoris	littoris
terminus	terminus
Τέλος	Τέλος
XXIIII	XXIIII
Aprilis	Aprilis
1450	1450
Antheus	Antheus
Anthei	Anthei
tu	tu
lus	lus
GNA	GNA
fl	fl
Ampelusia	Ampelusia
rentur	rentur
inanes	inanes
alique	alique
fuisse	fuisse
que	que
furti	furti
eẽnt	essent

excicate	excicate
sic	sic
tu	tu
et̃	etiam
sic	sic
q̃d	quod
scribes	scribes
scribito	scribito
tm̃	tamen
ne	ne
furtũ	furtum
cessationis	cessationis
que	que
simile	simile
videas	videas
Ualde	Ualde
eĩ	enim
mi	mi
semꝑ	semper
et	et
uera	uera
et	et
dulcia	dulcia
tuis	tuis
epl̃is	epistulis

nũciantur	nunciantur
Ama	Ama
nos	nos
et	et
uale	uale
Quintus	Quintus
Cicero	Cicero
Tironi	Tironi
suo	suo
sal̃	salutem
p.	plurimam
dicit	dicit
MIrificaui	MIrificaui
mi	mi
uerberationem	uerberationem
cessatiõis	cessationis
epl̃a	epistula
dedisti	dedisti
Nam	Nam
que	que
frater	frater
ꝑtius	partius
ꝑscripserat	perscripserat
uerecondia	uerecondia
u	uidelicet

et	et
proꝑa	propera
tione	tione
eã	eam
tu	tum
sine	sine
assensione	assensione
ut	ut
erant	erant
de	de
me	me
scripsisti	scripsisti
et	et
maxime	maxime
coss.	consulibus
designatis	designatis
quos	quos
ego	ego
pẽitus	penitus
noui	noui
libidinũ	libidinum
et	et
langoris	langoris
et	et
effe	effe

minatissimi	minatissimi
ãi	animi
plenos	plenos
qui	qui
ubi	ubi
a	a
gubernaculis	gubernaculis
recesẜint	recesserint
maxĩu	maximum
ab	ab
uniuerso	uniuerso
naufragio	naufragio
ꝑiculũ	periculum
est	est
Incredibile	Incredibile
est	est
que	que
ego	ego
illos	illos
scio	scio
appoĩtis	appositis
galloru	gallorum
castris	castris
ĩ	in
estiuis	estiuis

fecisse	fecisse
quos	quos
ille	ille
latro	latro
ubi	ubi
aliquid	aliquid
firmius	firmius
fuit	fuit
societate	societate
uitiorũ	uitiorum
deliniet	deliniet
Res	Res
est	est
aut	aut
tri	tri
bunicis	bunicis
consiliis	consiliis
minuenda	minuenda
Nam	Nam
isti	isti
duo	duo
uix	uix
sunt	sunt
digni	digni
quibus	quibus

alteri	alteri
Cossutiͣnarum	Cossutianarum
tabernarum	tabernarum
fundamenta	fundamenta
credas	credas
Te	Te
ut	ut
dixi	dixi
fere	fere
celeris	celeris
Ego	Ego
uos	uos
ad	ad
IIII	IIII
kl̃	kalendas
uidebo	uidebo
tuosq	tuosque
oculos	oculos
et	et
si	si
te	te
uenies	uenies
ĩ	in
medio	medio
foro	foro

siquidẽ	siquidem
res	res
gestas	gestas
utriusq	utriusque
suꝑgressus	supergressus
uniuersam	uniuersam
hyspaniã	hyspaniam
domuit	domuit
Inde	Inde
romanis	romanis
illato	illato
bello	bello
ytaliam	ytaliam
ꝑ	per
annos	annos
sexdecim	sexdecim
uariis	uariis
cla	cla
dibus	dibus
fatigauit	fatigauit
Cum	Cum
interea	interea
Romani	Romani
missis	missis
in	in

hyspania	hyspania
Scipionibus	Scipionibus
primo	primo
poenos	poenos
prouincia	prouincia
expulerunt	expulerunt
postea	postea
cũ	cum
ipsis	ipsis
hyspanis	hyspanis
grauia	grauia
bella	bella
gesserunt	gesserunt
Nec	Nec
prius	prius
ꝑdomite	perdomite
prouincie	prouincie
iugumq	iugumque
hyspani	hyspani
accipere	accipere
potuerunt	potuerunt
ꝙͣ	quam
Cesar	Cesar
Augustus	Augustus
perdomito	perdomito

orbe	orbe
uictricia	uictricia
ad	ad
eos	eos
arma	arma
transtulit	transtulit
populumq	populumque
ferum	ferum
ac	ac
barbarum	barbarum
legibus	legibus
ad	ad
cultiorem	cultiorem
uite	uite
usum	usum
traductum	traductum
in	in
formã	formam
prouincie	prouincie
redegit	redegit
DEO	DEO
GRATIAS	GRATIAS
HISPANI	HISPANI
IUSTINI	IUSTINI
XXXXIIIIor	XXXXIIIIor

UOLUMI	UOLUMI
NUM	NUM
TROGI	TROGI
POMPEI	POMPEI
ABREVIATORIS	ABREVIATORIS
LIBER	LIBER
EXPLICIT	EXPLICIT
Scriptum	Scriptum
per	per
me	me
dominicũ	dominicum
Macth̃i	Macthei
de	de
Reate	Reate
manu	manu
ꝓͥa	propria
REATE	REATE
MCCCCLIII	MCCCCLIII
IIII	IIII
kl̃	kalendas
Maii	Maii
RISSIMUM	RISSIMUM
IMPERATOREM	IMPERATOREM
AC	AC
ILLUSTRISSIMUM	ILLUSTRISSIMUM

PRIN	PRIN
CIPEM	CIPEM
COMITEM	COMITEM
FRANCIS	FRANCIS
CUM	CUM
SFORTIAM	SFORTIAM
VICECO	VICECO
MITEM	MITEM
Francisci	Francisci
Aleardi	Aleardi
ueronẽsis	ueronensis
lau	lau
datio	datio
NON	NON
dubito	dubito
fore	fore
ꝑ	per
mul	mul
tos	tos
Princeps	Princeps
illustrissi	illustrissi
me	me
qui	qui
rerum	rerum
tuarũ	tuarum

magnitudinem	magnitudinem
admi	admi
rati	rati
pręstanti	pręstanti
ingenio	ingenio
uiri	uiri
litteris	litteris
et	et
monu	monu
mentis	mentis
suis	suis
eas	eas
mandare	mandare
et	et
illustrare	illustrare
conabuntur	conabuntur
partim	partim
ut	ut
gratiam	gratiam
tuã	tuam
quam	quam
uel	uel
sũmis	summis
opibus	opibus
uel	uel

amplissĩs	amplissimis
diuitiis	diuitiis
merito	merito
anteponant	anteponant
facilius	facilius
cõ	con
sequantur	sequantur
Partim	Partim
ut	ut
in	in
tuis	tuis
rebus	rebus
mendandis	mendandis
uel	uel
ingenia	ingenia
sua	sua
exerceant	exerceant
uel	uel
in	in
te	te
collaudando	collaudando
materiam	materiam
nacti	nacti
copiosissimam	copiosissimam
nomen	nomen

suum	suum
quoq.	quoque
ĩmortalitati	immortalitati
transmittant	transmittant
Deniq.	Denique
nõ	non
incideret	incideret
&	et
uox	uox
inde	inde
erupit	erupit
&	et
sanguis	sanguis
sicut	sicut
docet	docet
Ouidi᷒	Ouidius
driades	driades
uõ	uero
s̃t	sunt
quę	quę
ĩter	inter
arbores	arbores
habitant	habitant
hoc	hoc
aut̃	autem

ad	ad
suꝑiora	superiora
ꝑtinet	pertinet
quę	quę
dixerat	dixerat
mixtis	mixtis
lustrabo	lustrabo
menala	menala
nimphis	nimphis
Nec	Nec
carmina	carmina
uobis	uobis
ipa	ipsa
placẽt	placent
	quia
dixerat	dixerat
carmina	carmina
pastoris	pastoris
siculi	siculi
modulabor	modulabor
auena	auena
Ipsę	Ipsę
rursus	rursus
cõcedite	concedite
siluę	siluę

ꝑꝑ	propter
illud	illud
Iam	Iam
mihi	mihi
ꝑ	per
rupes	rupes
videor	videor
lucosq	lucosque
sonãtes	sonantes
Nec	Nec
si	si
frigorib.	frigoribus
mediu	medium
ebrũq	ebrumque
bibamus	bibamus
manifeste	manifeste
hoc	hoc
dicit	dicit
amor̃	amore
se	se
carer̃	carere
nõ	non
posse	posse
Nec	Nec
si	si

ebrum	ebrum
Tracię	Tracię
fluuiũ	fluuium
mediis	mediis
frigorib.	frigoribus
bibat	bibat
nec	nec
estib.	estibus
nimiis	nimiis
fiunt	fiunt
ĩ	in
ardẽti	ardenti
ꝓuincia	prouincia
dicit	dicit
aut̃	autem
hoc	hoc
ẜm	secundum
phisicos	phisicos
qui	qui
morbos	morbos
aut	aut
a	a
ꝯtrariis	contrariis
aut	aut
a	a

similib.	similibus
asserũt	asserunt
posse	posse
depelli	depelli
Sitionasq	Sitionasque
niues	niues
Siton	Siton
mons	mons
ẽ	est
tracię	tracię
liber	liber
corticis	corticis
pars	pars
ĩterior	interior
Uersemur	Uersemur
pascamus	pascamus
hec	hec
sat	sat
erit	erit
Iam	Iam
ad	ad
musas	musas
loquitur	loquitur
gracili	gracili
fiscellã	fiscellam

alnus	alnus
Amo	Amo
inquit	inquit
Gallũ	Gallum
sed	sed
latenter	latenter
sicut	sicut
arbores	arbores
crescũt	crescunt
nam	nam
oꝑatio	operatio
ista	ista
hoc	hoc
significat	significat
ꝑꝑ	propter
cęsarẽ	cęsarem
Et	Et
frugib.	frugibus
umbrę	umbrę
quãto	quanto
magis	magis
hõib.	hominibus
uñ	unde
&̃	etiam
ĩ	in

georgicis	georgicis
&	et
auris	auris
optati	optati
f	f
p	p
u	u
Ite	Ite
domũ	domum
Saturę	Saturę
uenit	uenit
hesꝑus	hesperus
ite	ite
capellę	capellę
uerecũde	uerecunde
se	se
capellaꝝ	capellarum
dicit	dicit
pastorẽ	pastorem
.i.	idest
uilissimoꝝ	uilissimorum
animaliu	animalium
Nam	Nam
buccolica	buccolica
scribẽs	scribens

debuit	debuit
se	se
dicer̃	dicere
boum	boum
eẽ	esse
pastorẽ	pastorem
s	sed
uitãs	uitans
ãogãtiam	arogantiam
ultimũ	ultimum
se	se
uoluit	uoluit
eẽ	esse
principẽ	principem
ĩ	in
scribẽdis	scribendis
buccolicis	buccolicis
finis	finis
Uiterbii	Uiterbii
MͦCCCCLV	MoCCCCLV
mẽs̃	mensis
maii	maii
N.	Nicolao
V	V
pont̃	pontifice

Mͦ	Maximo
sedẽte	sedente
Ego	Ego
Angl̃us	Angelus
scarponi᷒	scarponius
scolaris	scolaris
hũc	hunc
librũ	librum
scripsi	scripsi
De	De
uassano	uassano
scilic	scilicet
ortañ	ortanensis
dioc̃	diocesis
cepit	cepit
q̃	que
iasoni	iasoni
hoc	hoc
ordine	ordine
tͣdidit	tradidit
ꝯser	conser
uanda	uanda
De	De
tͣditõe	traditione
Rerũ	Rerum

ad	ad
incãtand̃	incantandum
IN	IN
pͥmis	primis
tͣdidit	tradidit
ei	ei
quãd̃	quandam
ymaginẽ	ymaginem
ar	ar
genteã	genteam
ꝙͣ	quam
dixit	dixit
esse	esse
ꝑ	per
incantatõem	incantationem
nodos	nodos
	et
ml̃ti	multi
artificii	artificii
ũtute	uirtute
cõstruc	construc
tam	tam
q̃	que
adũsus	aduersus
incantatões	incantationes

iã	iam
fc̃as	factas
ẽ	est
ualde	ualde
potissĩa	potissima
cassans	cassans
uidel	uidelicet
q̃	que
fc̃a	facta
Iam	Iam
sũt	sunt
&	et
eoꝝ	eorum
uotiua	uotiua
expulsione	expulsione
fina	fina
li	li
Repellens	Repellens
De	De
hac	hac
gͥ	igitur
iasonẽ	iasonem
sͨ	sic
instͧ	instru
xit	xit

ut	ut
eã	eam
caute	caute
supͣ	supra
se	se
deferat	deferat
nã	nam
ad	ad
ũsus	uersus
incantatões	incantationes
qͣsl	quaslibet
ualere	preualere
se	se
sciet	sciet
uociuoꝝ	uociuorum
incantatõis	incantationis
uirib	uiribus
anl̃	anel
latis	latis
Scd̃o	Secundo
sͥ	sibi
tradidͭ	tradidit
cui᷒dã	cuiusdam
umguẽti	umguenti
odoriferi	odoriferi

medicamẽ	medicamen
quo	quo
ip̃m	ipsum
liuire	liuire
suasit	suasit
asẜens	asserens
in	in
eo	eo
ũtutẽ	uirtutem
ineẽ	inesse
ut	ut
ad	ad
ũsus	uersus
ꝯflãmas	conflammas
ualde	ualde
ualeat	preualeat
extin	extin
gat	gat
incendia	incendia
⁊	et
om̃e	omne
ꝙ	quod
h̃t	habet
potenciã	potenciam
ꝯburendi	comburendi

incessa	incessa
fumositate	fumositate
Resol	Resol
uat	uat
Dem̃	Demum
ꝙͣdã	quamdam
anulũ	anulum
sͥ	sibi
dedit	dedit
in	in
quo	quo
talis	talis
ũtutũ	uirtutum
lapis	lapis
erat	erat
inclusus	inclusus
ut	ut
q̃cũq	quecumque
uenena	uenena
corriꝑẽt	corriperent
corũ	corum
nocum̃	nocumen
ta	ta
Repelleret	Repelleret
⁊	et

ꝙͣ	quam
ueneni	ueneni
Rabies	Rabies
ꝑ	per
fusa	fusa
forsan	forsan
infic̃et	inficeret
uelut	uelut
ab	ab
aqͥs	aquis
in	in
nã	nam
de	de
qua	qua
illũ	illum
instuxit	instuxit
ut	ut
ꝙͣ	quam
pͥmũ	primum
ꝑueniret	perueniret
ad	ad
boues	boues
licore	licore
illo	illo
in	in

eoꝝ	eorum
o	o
ra	ra
ꝑfund̃et	perfunderet
	et
crebris	crebris
asꝑsionib	aspersionibus
irro	irro
raret	raret
In	In
licore	licore
ẽ	est
illo	illo
hanc	hanc
ineẽ	inesse
uir	uir
tutẽ	tutem
asẜunt	asserunt
ut	ut
ꝙͣ	quam
pͥmũ	primum
ora	ora
boum	boum
in	in
fũderent᷑	funderentur

ex	ex
ab	ab
illo	illo
uelut	uelut
q̃d	quod
uiscoso	uiscoso
glutino	glutino
sͨ	sic
ꝯpacta	compacta
ꝯstring̃ent᷑	constringerentur
ĩ	in
unũ	unum
ꝙ	quod
eoꝝ	eorum
aꝑtura	apertura
nõ	non
tam	tam
difficilis	difficilis
ꝙͣ	quam
im	im
possibilis	possibilis
eẽt	esset
in	in
illis	illis
	et

sͨ	sic
de	de
singl̃is	singulis
suc	suc
cessiue	cessiue
medea	medea
Iasonẽ	Iasonem
diligent̃	diligenter
instͧ	instru
xit	xit
Medea	Medea
gͥ	igitur
suis	suis
instructionib	instructionibus
	et
doc	doc
trinis	trinis
sͨ	sic
demũ	demum
finẽ	finem
imposuit	imposuit
et	et
da	da
ta	ta
iasoni	iasoni

licentia	licentia
Recedẽdi	Recedendi
añ	ante
diei	diei
cõminãtis	comminantis
lucis	lucis
aduent̃	aduentum
Iason	Iason
in	in
de	de
cretã	cretam
sͥ	sibi
Camerã	Cameram
furtiuis	furtiuis
passib	passibus
se	se
Recepit	Recepit
Insurgẽte	Insurgente
gͥ	igitur
Roseis	Roseis
aurora	aurora
splendori	splendori
b	bus
et	et
sole	sole

aureo	aureo
luce	luce
modica	modica
Cacumĩa	Cacumina
montiũ	montium
illustrante	illustrante
iason	iason
futiuo	futiuo
surgit	surgit
a	a
thalamo	thalamo
in	in
comitia	comitia
uidel	uidelicet
h̃culis	herculis
	et
suoꝝ	suorum
	et
oetis	oetis
Regis	Regis
adiuit	adiuit
soliũ	solium
in	in
quo	quo
ipe	ipse

Rex	Rex
iam	iam
se	se
Receꝑat	Receperat
ml̃toꝝ	multorum
astanti	astanti
choraule	choraule
pallio	pallio
tyriantino	tyriantino
quo	quo
ille	ille
uelut	uelut
spolio	spolio
nobilitatis	nobilitatis
exultat	exultat
me	me
sale	sale
nomẽ	nomen
uxõis	uxoris
iam	iam
ꝗd	quid
lineas	lineas
petitaᷤ	petitas
egypto	egypto
loquar	loquar

Quid	Quid
tyro	tyro
et	et
sydona	sydona
tenuitate	tenuitate
ꝑ	per
lucidaᷤ	lucidas
micãtes	micantes
pũpura	purpura
plumãdi	plumandi
difficultate	difficultate
ꝑ	per
nobiles	nobiles
dõa	dona
ti	ti
sũ	sun
atrabatitis	atrabatitis
biri	biri
petiti	petiti
donati	donati
bi	bi
ri	ri
canussini	canussini
africane	africane
opes	opes

et	et
balteõib.	balteonibus
deputarẽt	deputarent
Habe	Habe
mi	mi
amice	amice
meũ	meum
mim᷒	mimus
ꝙ	quod
ego	ego
ut	ut
sepe	sepe
dixi	dixi
nõ	non
eloquiẽtie	eloquientie
causa	causa
sed	sed
cũiositatis	curiositatis
in	in
lumẽ	lumen
Edidi	Edidi
id	id
ci	preci
pue	pue
agẽs	agens

ut	ut
siꝗs	siquis
eloquẽs	eloquens
uellet	uellet
fc̃a	facta
prĩcipu	principum
reẜare	reserare
materiã	materiam
nõ	non
reꝗuir̃et	requiuireret
h̃ituros	habituros
meos	meos
libellos	libellos
ministros	ministros
elo	elo
quii	quii
te	te
queso	queso
sis	sis
ꝯtẽtus	contentus
nosq.	nosque
sic	sic
uo	uo
luisse	luisse
scribere	scribere

meli᷒	melius
ꝙͣ	quam
potuisse	potuisse
contẽ	conten
das	das
Fe	Fe
Li	Li
Ci	Ci
Ter	Ter
Am̃	Amen
Explicite	Explicite
uite	uite
Diuersoꝝ	Diuersorum
Prĩcipũ	Principum
Et	Et
Tyrãnoꝝ	Tyrannorum
A	A
diuo	diuo
Adriano	Adriano
usq	usque
ad	ad
Num̃	Numer
ianum	ianum
Feliciter	Feliciter
Ut̃e	Utere

Felix	Felix
Script᷒	Scriptus
fuit	fuit
sub	sub
Millĩo	Millesimo
cccͦ	ccco
LVI	LVI
de	de
mense	mense
febr̃	februario
Et	Et
scripsit	scripsit
eum	eum
Frat̃	Frater
ioh̃es	iohannes
de	de
Campagnola	Campagnola
Regiñ	Reginensis
dioc̃	diocesis
Deo	Deo
G̃as	Gratias
Am̃	Amen
Am̃	Amen
am̃	amen
PEr	PEr

correr	correr
miglior	miglior
aqq	aqque
Omai	Omai
la	la
nauicella	nauicella
del	del
mio	mio
in	in
Che	Che
lascia	lascia
dietro	dietro
a	a
se	se
mar	mar
E	E
cantero	cantero
di	di
quel	quel
secondo	secondo
Oue	Oue
l	l
'	'
umano	umano
spirito	spirito

si	si
pur	pur
E	E
di	di
salir	salir
a	a
ddio	ddio
diuenta	diuenta
de	de
Ma	Ma
qui	qui
la	la
morta	morta
poesi	poesi
ri	ri
O	O
sante	sante
muse	muse
poi	poi
che	che
uost	uost
E	E
qui	qui
caliope	caliope
alquanto	alquanto

sur	sur
Seghuitando	Seghuitando
el	el
mio	mio
canto	canto
con	con
quel	quel
sono	sono
di	di
chui	chui
le	le
picche	picche
misere	misere
sentiro	sentiro
lo	lo
colpo	colpo
tal	tal
che	che
desperar	desperar
ꝑdono	perdono
Dolce	Dolce
color	color
d	d
'	'
oriental	oriental

zaphiro	zaphiro
Che	Che
s	s
'	'
acolgeua	acolgeua
nel	nel
sereno	sereno
aspecto	aspecto
Dilaer	Dilaer
puro	puro
insino	insino
al	al
primo	primo
giro	giro
Agli	Agli
occhi	occhi
mei	mei
ricomincio	ricomincio
dilecto	dilecto
tosto	tosto
ch	ch
'	'
io	io
usci	usci
de	de

l	l
'	'
aura	aura
morta	morta
Che	Che
m	m
'	'
auia	auia
contristati	contristati
gli	gli
occhi	occhi
e	e
'	'
l	l
p	p
Lo	Lo
bel	bel
pianeta	pianeta
che	che
d	d
'	'
amar	amar
conforta	conforta
Faceua	Faceua
tucto	tucto

rider	rider
l	l
'	'
oriente	oriente
Uelando	Uelando
ei	ei
pesci	pesci
ch	ch
'	'
eram	eram
in	in
sua	sua
scort	scort
REuerende	REuerende
discretõnis	discretionis
dño	domino
magr̃o	magistro
hugoni	hugoni
cantuariensis	cantuariensis
dñi	domini
ppͤ	pape
nuncio	nuncio
in	in
anglia	anglia
frater	frater

Nicolaus	Nicolaus
treueth	treueth
or	or
Recõmendatõne	Recommendatione
hũili	humili
Reũenciã	Reuerenciam
⁊	et
honorem	honorem
Antiquitat	Antiquitat
aliq̃d	aliquod
exordium	exordium
siue	siue
ꝑ	per
creationẽ	creationem
ut	ut
catholici	catholici
seu	seu
ꝑ	per
Iuno	Iuno
flagrationes	flagrationes
seu	seu
diluuia	diluuia
sicut	sicut
platonici	platonici
non	non

eodẽ	eodem
eã	eam
uallo	uallo
Inter	Inter
cet̃os	ceteros
aut̃	autem
maioris	maioris
uetustatis	uetustatis
assertores	assertores
ĩuẽ	inuen
sac̃dotib	sacerdotibus
insignẽ	insignem
int̃	inter
septẽ	septem
sapientes	sapientes
Solonẽ	Solonem
instruc	instruc
meo	meo
Saim	Saim
urbem	urbem
egipciacã	egipciacam
octo	octo
milib	milibus
annoꝝ	annorum
tũc	tunc

ste	ste
athenaꝝ	athenarum
ꝓcessit	processit
condicio	condicio
mille	mille
ãnis	annis
s	Sed
ml̃to	multo
antiquior	antiquior
hiis	hiis
fingit᷑	fingitur
gens	gens
eg	eg
cian᷒	cianus
in	in
ꝓlogo	prologo
astronomie	astronomie
sue	sue
qui	qui
ipo	ipso
libro	libro
rari᷒	rarius
inuenit᷑	inuenitur
ex	ex
ꝑsona	persona

sap̃ie	sapentie
ꝑ	per
assent	assent
uiguisse	uiguisse
Sed	Sed
hũc	hunc
antiquitatis	antiquitatis
positionẽ	positionem
uelut	uelut
fabulosis	fabulosis
fit	fit
augustin᷒	augustinus
de	de
ciuitate	ciuitate
dei	dei
libro	libro
12mo	12mo
non	non
solũ	solum
quia	quia
ueritati	ueritati
sacre	sacre
scͥpture	scripture
disso	disso
hystoriis	hystoriis

grecoꝝ	grecorum
qui	qui
int̃	inter
mũdi	mundi
sapientes	sapientes
ante	ante
Romanos	Romanos
habiti	habiti
s̃t	sunt
clariores	clariores
nimẽta	nimenta
declarãt	declarant
discrepare	discrepare
ꝙͣ	quam
pl̃imũ	plurimum
ĩuenitur	inuenitur
Quã	Quam
dissonãciã	dissonanciam
declarãs	declarans
sanc	sanc
docet	docet
quomͦ	quomodo
ut	ut
liquet	liquet
ex	ex

quadã	quadam
epl̃a	epistula
quã	quam
Matri	Matri
sue	sue
Olimpiadi	Olimpiadi
Alexander	Alexander
n	n
rioꝝ	riorum
Regno	Regno
ascribũt	ascribunt
egipcii	egipcii
annoꝝ	annorum
5000	5000
ampli᷒	amplius
cui	cui
greci	greci
nõ	non
ultra	ultra
1300	1300
ait	ait
tuq	tuque
ab	ab
eod̃	eodem
t̃mino	termino

sue	sue
sumant	sumant
cõputatõnis	computationis
pͥncipiũ	principium
uidel	uidelicet
ab	ab
exordio	exordio
regni	regni
B	B
ENEDICTUS	ENEDICTUS
ep̃us	episcopus
ẜuus	seruus
ẜuorum	seruorum
dei	dei
Ueñ	Uenerabili
fr̃i	fratri
Ep̃o	Episcopo
Magaloñ	Magalonensi
salt̃	salutem
⁊	et
apl̃icã	apostolicam
bñ	benedictionem
Dudum	Dudum
ad	ad
audientiam	audientiam

nr̃i	nostri
apl̃atus	apostolatus
ꝑuenit	peruenit
ꝑlate	perlate
quod	quod
ꝓ	pro
eo	eo
ꝙ	quod
in	in
Castro	Castro
de	de
brixiaco	brixiaco
Magaloñ	Magalonensis
dioc̃	diocesis
ad	ad
tuam	tuam
Magal̃	Magalonensem
eccam	ecclesiam
&	et
dilc̃m	dilectum
filiũ	filium
nobilem	nobilem
uirũ	uirum
Raymundum	Raymundum
petri	petri

Militem	Militem
dñm	dominum
Agaut	Agauticĩ
eiusd̃	eiusdem
dioc̃	diocesis
cõiter	communiter
ꝑtinẽte	pertinente
per	per
quosdam	quosdam
iudic̃	iudices
secular̃	seculares
cur̃	curie
cõis	communis
ecce	ecclesie
ac	ac
nobil̃	nobilium
dictoꝝ	predictorum
contͣ	contra
quadam	quadam
Michaelem	Michaelem
gaut͛ie	gauterie
et	et
Emẽgardam	Emengardam
de	de
carnic̃	carnicis

Inquisitor	Inquisitor
heretic̃	heretice
prauitat̃	prauitatis
in	in
illis	illis
partib	partibus
auct̃e	auctoritatee
apl̃ica	apostolica
deputati	deputati
ut	ut
dicebat᷑	dicebatur
iudiciũ	preiudicium
⁊	et
cõtemptum	contemptum
per	per
eũdem	eundem
Inquisitor	Inquisitor
seu	seu
de	de
mãdato	mandato
suo	suo
contͣ	contra
nonullas	nonullas
ꝑsonas	personas
c̃ti	certi

fuerãt	fuerant
facti	facti
ꝓcessus	processus
Ro	Ro
c̃tis	certis
ex	ex
caus̃	causis
tam	tam
de	de
toto	toto
ꝓcessu	processu
suꝑ	super
miss̃	premissione
habito	habito
per	per
dc̃os	dictos
Iudic̃es	Iudiceses
secular̃	seculares
ꝙͣ	quam
ꝓcessu	processu
predc̃o	predicto
per	per
eũdem	eundem
Inquisitor̃	Inquisitorem
uel	uel

de	de
suo	suo
Ad	Ad
Luchinum	Luchinum
uicecoͥtem	uicecomitem
mediolani	mediolani
dominu	dominum
cũ	cum
pira	pira
transmitteret	transmitteret
incidenter	incidenter
egit	egit
de	de
laudib.	laudibus
italie	italie
ARgolicas	ARgolicas
si	si
fama	fama
uolans	uolans
uulgata	uulgata
ꝑ	per
urbes	urbes
Arboris	Arboris
ausonie	ausonie
quondam	quondam

dum	dum
splenduit	splenduit
etas	etas
Aurea	Aurea
,	,
saturno	saturno
terris	terris
regnante	regnante
fuiss⁊	fuisset
Ut	Ut
reor	reor
eurysteus	eurysteus
nũꝙͣ	nunquam
tot	tot
ferre	ferre
labores	labores
Cogeret	Cogeret
alcydem	alcydem
,	,
sua	sua
ditia	ditia
poma	poma
draconi	draconi
Ortulus	Ortulus
hesperidum	hesperidum

male	male
custoditus	custoditus
haberet	haberet
Hoc	Hoc
potius	potius
mandaret	mandaret
opus	opus
nec	nec
uinceret	uinceret
auru	aurum
Natiui	Natiui
dulcoris	dulcoris
opes	opes
Felitius	Felitius
omni	omni
Es	Es
latium	latium
tellure	tellure
quidem	quidem
fertilis	prefertilis
ora	ora
Italie	Italie
ꝙͣ	quam
fulua	fulua
ceres	ceres

uiridisq.	uiridisque
minerua	minerua
Purpureus	Purpureus
ꝙͣ	quam
bachus	bachus
quã	quam
amat	amat
tu	tu
frõdea	frondea
capris	capris
Florea	Florea
mellificis	mellificis
apib.	apibus
pecoriq.	pecorique
uicissim	uicissim
Pascua	Pascua
et	et
irriguis	irriguis
late	late
pulcerrima	pulcerrima
pratis	pratis
Tu	Tu
redolens	redolens
ortis	ortis
uariis	uariis

in	in
luxum	luxum
fluens	fluens
saeculum	saeculum
grauib	grauibus
seuerisq	seuerisque
legibus	legibus
multis	multis
coercuit	coercuit
Ob	Ob
haec	haec
tot	tot
facta	facta
ingentia	ingentia
dictator	dictator
ꝑpetuus	perpetuus
et	et
pa	pa
ter	ter
patrię	patrię
dictus	dictus
est	est
Tractatum	Tractatum
etiam	etiam
in	in

sena	sena
tu	tu
an	an
quia	quia
condidisset	condidisset
imꝑium	imperium
romulus	romulus
uo	uo
caretur	caretur
sed	sed
sanctius	sanctius
er	er
reuerentius	reuerentius
uisum	uisum
est	est
nomen	nomen
augusti	augusti
ut	ut
scilicet	scilicet
iamdudum	iamdudum
du	dum
colit	colit
terras	terras
ipo	ipso
nomine	nomine

et	et
titulo	titulo
consecret᷑	consecretur
L	L
Annei	Annei
Flori	Flori
liber	liber
ultimus	ultimus
anno	anno
dñi	domini
1458	1458
III	III
noñ	nonas
ianuar̃	ianuarias
Mlĩ	Mediolani
Deo	Deo
laus	laus
EGO	EGO
OMNI	OMNI
OFFICIO	OFFICIO
AC	AC
POTI᷒	POTIus
pietate	pietate
erga	erga
te	te

ceteris	ceteris
satisfacio	satisfacio
omnibus	omnibus
mi	mi
hi	hi
ipse	ipse
nunꝙͣ	nunquam
satisfacio	satisfacio
Tanta	Tanta
enim	enim
est	est
ma	ma
gnitudo	gnitudo
tuorum	tuorum
erga	erga
me	me
meritorum	meritorum
ut	ut
quo	quo
niam	niam
tu	tu
nisi	nisi
perfecta	perfecta
re	re
de	de

me	me
non	non
conquie	conquie
sti	sti
ego	ego
	quia
idem	idem
in	in
tua	tua
causa	causa
non	non
officio	officio
uitã	uitam
mihi	mihi
esse	esse
acerbam	acerbam
putem	putem
In	In
causa	causa
hęc	hęc
sunt	sunt
Hamonius	Hamonius
regis	regis
legatus	legatus
aperte	aperte

pecunia	pecunia
nos	nos
oppugnat	oppugnat
Res	Res
agitur	agitur
per	per
eosdem	eosdem
competi	competi
tores	tores
per	per
quos	quos
cum	cum
tu	tu
aderas	aderas
agebatur	agebatur
Regis	Regis
causa	causa
si	si
qui	qui
sunt	sunt
qui	qui
uelint	uelint
ꝗ	qui
pauci	pauci
sunt	sunt

omnes	omnes
rem	rem
ad	ad
pompeium	pompeium
deferri	deferri
uolunt	uolunt
Senatus	Senatus
religionis	religionis
calũ	calum
niam	niam
non	non
religione	religione
sed	sed
maleuolentia	maleuolentia
&	et
illius	illius
regiae	regiae
Largitionis	Largitionis
inuidia	inuidia
cõ	com
probat	probat
Pompeium	Pompeium
et	et
hortari	hortari
et	et

orare	orare
et	et
iam	iam
Liberius	Liberius
accusare	accusare
et	et
monere	monere
ut	ut
magnam	magnam
infamiam	infamiam
fugiat	fugiat
non	non
desistimus	desistimus
Sed	Sed
plane	plane
nec	nec
precibus	precibus
nr̃is	nostris
si	si
quid	quid
ob	ob
commissorum	commissorum
penitenciam	penitenciam
eligitis	eligitis
uel	uel

iniuria	iniuriam
amicis	amicis
uestris	uestris
ne	ne
a	a
nicomede	nicomede
inferri	inferri
sinite	sinite
Sic	Sic
eni	eni
faciẽ	facien
tibus	tibus
uobis	uobis
auxilia	auxilia
contra	contra
italos	italos
regem	regem
nostrum	nostrum
laturum	laturum
pollicemur	pollicemur
uel	uel
apparentem	apparentem
amiciciam	amiciciam
saltem	saltem
dissoluite	dissoluite

uel	uel
romam	romam
ad	ad
iudicium	iudicium
contendamus	contendamus
una	una
Sic	Sic
pelopidas	pelopidas
elocutus	elocutus
est	est
Hi	Hi
autem	autem
insolenciis	insolenciis
illum	illum
loqui	loqui
arbitrantes	arbitrantes
mitridatem	mitridatem
a	a
nicomede	nicomede
et	et
capadocia	capadocia
abstiñe	abstinere
imperant	imperant
se	se
statim	statim

Ariobarzanem	Ariobarzanem
in	in
eam	eam
reducturos	reducturos
esse	esse
pelopidam	pelopidam
insuper	insuper
ab	ab
exercitu	exercitu
cedere	cedere
iubent	iubent
nec	nec
ulterius	ulterius
ad	ad
eos	eos
reuerti	reuerti
nisi	nisi
in	in
his	his
que	que
mandata	mandata
essent	essent
permaneret	permaneret
rex	rex
In	In

hunc	hunc
mod̃	modum
tulere	tulere
sentenciam	sentenciam
et	et
discendenti	discendenti
abinde	abinde
pelopi	pelopi
de	de
custodiam	custodiam
adhibuere	adhibuere
ne	ne
quempiam	quempiam
in	in
itinere	itinere
ꝑuert̃et	peruerteret
Quibus	Quibus
peractis	peractis
consilia	consilia
tanti	tanti
belli	belli
neutiq	neutique
expectantes	expectantes
aut	aut
ut	ut

populo	populo
nota	nota
fierent	fierent
et	et
galatis	galatis
qui	qui
in	in
asia	asia
sunt	sunt
statim	statim
mouent	mouent
Verum	Verum
quia	quia
propius	propius
ipis	ipsis
exercitus	exercitus
aderat	aderat
quem	quem
lu	lu
cassius	cassius
asie	asie
proconsul	proconsul
retinebat	retinebat
et	et
omnes	omnes

socioꝝ	sociorum
uires	uires
ĩ	in
unũ	unum
conuenerant	conuenerant
dispartitis	dispartitis
copiis	copiis
unusquisq	unusquisque
castra	castra
ponit	ponit
Cas	Cas
sius	sius
bithinie	bithinie
et	et
galacie	galacie
in	in
medio	medio
in	in
annis	annis
per	per
inferiora	inferiora
bithi	bithi
Hoc	Hoc
priuilegium	priuilegium
a	a

dño	domino
ppͣ	papa
nobis	nobis
et	et
ecclesie	ecclesie
nostre	nostre
concessum	concessum
loquitur	loquitur
de	de
om̃ibus	omnibus
terriᷤ	terris
quas	quas
habet	habet
eccl̃a	ecclesia
nr̃a	nostra
ubicumq	ubicumque
sint	sint
Alexander	Alexander
episcopus	episcopus
seruus	seruus
seruorum	seruorum
dei	dei
dilectis	dilectis
filiis	filiis
Andree	Andree

decano	decano
eccl̃e	ecclesie
sancti	sancti
auiti	auiti
eiusq	eiusque
fratrib	fratribus
tam	tam
presentib	presentibus
quam	quam
futuris	futuris
ca	ca
nonice	nonice
sustituendis	sustituendis
in	in
ꝑpetuum	perpetuum
Quotiens	Quotiens
a	a
no	no
bis	bis
illud	illud
petitur	petitur
quod	quod
religioni	religioni
et	et
honestati	honestati

con	con
dere	dere
et	et
petentium	petentium
desideriis	desideriis
congruum	congruum
inperti	inperti
ri	ri
suffragium	suffragium
Eaꝓpter	Eapropter
dilecti	dilecti
in	in
dño	domino
filii	filii
uestris	uestris
iustis	iustis
postulationib	postulationibus
clementer	clementer
annuimus	annuimus
et	et
cũcta	cuncta
illũĩans	illuminans
os	os
d̃i	dei
lingua	lingua

ignita	ignita
sap̃iam	sapentiam
ꝓmẽs	promens
fons	fons
iugit͛	iugiter
sa	sa
nitates	nitates
emanãs	emanans
Qui	Qui
mare	mare
ĩ	in
meabl̃ib	meabilibus
gͤssib᷒	gressibus
sc̃ificasti	sanctificasti
Qͥ	Qui
t̃rã	terram
p᷑pureã	purpuream
tuo	tuo
cruore	cruore
fecisti	fecisti
qͥ	qui
celos	celos
cõmeasti	commeasti
uͥ	ubi
ĩ	in

medio	medio
diuine	diuine
aciei	aciei
refulges	refulges
ĩ	in
splendore	splendore
ĩmarcessibilis	inmarcessibilis
gl̃ie	glorie
splendes	splendes
In	In
exul	exul
tatõne	tatione
Iocũditatis	Iocunditatis
ĩsaciabilis	insaciabilis
gaudes	gaudes
h̃	hec
theodorus	theodorus
Augustinus	Augustinus
hoc	hoc
nom̃	nomen
sortitus	sortitus
ẽ	est
ul̃	ue
ꝑꝑ	propter
ethi	ethi

mologiã	mologiam
nõis	nominis
ꝓpt̃	propter
excellentiã	excellentiam
dignitatis	dignitatis
qm̃	quoniam
sic̃	sicut
ĩꝑator	imperator
au	au
gustus	gustus
cellebat	precellebat
õs	omnes
reges	reges
sic	sic
	et
iste	iste
excellit	excellit
õs	omnes
doctores	doctores
ẜ	secundum
ꝙ	quod
dicit	dicit
remigi᷒	remigius
unde	unde
alii	alii

doctores	doctores
ꝯꝑant᷑	comparantur
stellis	stellis
dañ	danielis
xii	xii
Qui	Qui
ad	ad
iustĩam	iustiam
erudiunt	erudiunt
ml̃tos	multos
sic̃	sicut
stelle	stelle
⁊	et
c̃	cetera
hic	hic
aut̃	autem
ꝯꝑat᷑	comparatur
soli	soli
sic̃	sicut
p	paulus
ĩ	in
epl̃a	epistula
q̃	que
de	de
eo	eo

me	me
ĩ	in
affc̃m	affectum
ml̃tũ	multum
ĩusitatũ	inusitatum
ĩtrorsus	introrsus
nescio	nescio
ad	ad
qͣm	quam
dulcedinẽ	dulcedinem
q̃	que
si	si
ꝑficiat᷑	perficiatur
ĩ	in
me	me
nescio	nescio
qͥd	quid
erit	erit
ꝙ	quod
uita	uita
ista	ista
nõ	non
erit	erit
T̃cio	Tercio
p̃p	propter

ethy	ethy
mologiam	mologiam
nõis	nominis
Dicit᷑	Dicitur
eĩ	enim
augustin᷒	augustinus
ab	ab
augeo	augeo
⁊	et
astim	astim
q̃d	quod
ẽ	est
ciuitas	ciuitas
	et
ana	ana
q̃d	quod
ẽ	est
sursũ	sursum
Inde	Inde
aug̃	augustinus
qiͣ	quasi
augens	augens
su	su
ꝑnã	pernam
ciuitatẽ	ciuitatem

uñ	unde
de	de
eo	eo
cantat᷑	cantatur
Qui	Qui
ualuit	preualuit
amplificare	amplificare
ciuitatẽ	ciuitatem
	et
c̃	cetera
ul̃	ue
ut	ut
dr̃d	dicitur
in	in
glosario	glosario
aug̃	augustinus
dr̃d	dicitur
magnificus	magnificus
felix	felix
clarus	preclarus
in	in
doctrina	doctrina
fuit	fuit
·H·	enim
magnificus	magnificus

ĩ	in
uita	uita

