token	normalised
ci	ci
coumence	coumence
li	li
dialogues	dialogues
que	que
postumiens	postumiens
gallus	etgallus
distrent	distrent
de	de
seint	seint
martin	martin
des	etdes
moines	moines
d	d
egẏ	egy
pte	pte
si	si
ꝯ	com
seuerus	severus
le	le
raꝯte	raconte
qͥ	qi
les	les
oi	oï
ꝑler	parler
un	un
ior	jor
auint	avint
qe	qe
ie	je
gallus	gallus
et	et
mes	mes
chiers	chiers
compains	compains
qi	qi
deciples	deciples
fu	fu
seint	seint
martin	martin
estions	estions
ensamble	ensamble
laou	laou
nos	nos
ꝑlions	parlions
depluiseurs	depluiseurs
chosespostumiens	chosespostumiens
i	uns
miens	miens
tres	tres
chiers	chiers
amis	amis
uint	vint
deuers	devers
oriēt	orient
deuers	etdevers
la	la
terre	terre
d	d
egẏpte	egypte
ouil	ouil
auoit	avoit
iii	iii
anz	anz
demoreqant	demoréqant
ie	je
le	le
ui	vi
iefui	jefui
mout	mout
liez	liez
desa	desa
uenuesi	venuesi
lacolai	lacolai
baisai	etbaisai
	et
ꝯmen	conmen
cames	çames
aplorer	aplorer
li	li
uns	uns
uers	vers
lautre	lautre
de	de
ioie	joie
un	etun
pou	pou
apres	aprés
sinos	sinos
asseimes	asseïmes
dont	dont
me	me
regarda	regarda
postumiens	postumiens
si	etsi
dist	dist
laouieestoieesdaerrenierespartiesdegẏpteilmeplotuintenuolenteqeiemenalassealamer.qantieiuingieitrouaiunenefchargiedepluisorsauoirs.qisaparelloientamouoir.poraleranerbone.encelenuitsicomieestoiecouchiezmeuintenauision:qetuuenoiesdeuantmoisimesambloit.qetumeuoloiesꝑlameinenceleneftreireporceqeieientrasseqeiecauenisse.qantlanuizfutrespasseeliiorsfuuenuz.iefuileuezdelleuouieauoiegeuiemepensaideceleauisionqeieꝑsongesauoieueuesifuimeintenantesprisdunesigrantamoruerstoi:qeieentraisanzdemoranceenlanef.etlorsmeumessiuenimestantꝑlauolontenostresignor:qaltrentimeiorariuamesamarselledelauingieciauuintismeior.orestreisonqetumefacesgrantfestepuisqeiaiportoitanteterretantemertrespassee.	laoujeestoieesdaerrenierespartiesdegypteilmeplotetvintenvolentéqejemenalassealamer.qantjeivingjeitrovaiunenefchargiedepluisorsavoirs.qisaparelloientamovoir.poraleranerbone.encelenuitsicomjeestoiecouchiezmevintenavision:qetuvenoiesdevantmoietsimesambloit.qetumevoloiesparlameinenceleneftreireporceqejeientrasseetqejeçavenisse.qantlanuizfutrespasseeetlijorsfuvenuz.etjefuilevezdelleuoujeavoiegeüjemepensaideceleavisionqejeparsongesavoieveüesifuimeintenantesprisdunesigrantamorverstoi:qejeentraisanzdemoranceenlanef.etlorsmeümessivenimestantparlavolonténostresignor:qaltrentimejorarivamesamarselleetdelavingjeciauvintismejor.orestreisonqetumefacesgrantfestepuisqejaiportoitanteterreettantemertrespassee.
ie	je
seuerus	severus
respondi	respondi
a	a
postumien	postumien
qi	qi
tieus	tieus
choses	choses
mot	mot
contees	contees
laoutuestoiesenegẏptetuidemoroiespensoieieleiorlanuitatoi.mesorteprieieqetunosracontestoteslesauenturesdetauoie:ꝯmentlafoinostresignorestenorientgardeeqeleriuleqeleinstitutionsiestasmoignesdonee.quelsmiraclesquelsuertus.nostresiresiesucrizifetporsesserzqilaorentseruentcroient.etporceqelauieestmoltannieuseapluisorsgenzencesteregionencestecontree,uoudroieiedetoimoutuolentiersoirentendre.silfaitbonuiuresontensuserenlermitage.	laoutuestoiesenegypteettuidemoroiespensoiejelejoretlanuitatoi.mesortepriejeqetunosracontestoteslesaventuresdetavoie:etconmentlafoinostresignorestenorientgardeeetqeleriuleetqeleinstitutionsiestasmoignesdonee.etquelsmiraclesetquelsvertus.nostresiresjesucrizifetporsesserzqilaorentetserventetcroient.etporceqelavieestmoltannieuseapluisorsgenzencesteregionetencestecontree,voudroiejedetoimoutvolentiersoïretentendre.silfaitbonvivreetsontensuserenlermitage.
aces	aces
ꝑoles	paroles
respondi	respondi
postumiens	postumiens
si	etsi
dist	dist
ieferaiceqeieteuoidesirrer.portauolonteacomplir.mesietepriqetumediesselieuesqedecestecontree.sontdautelmaniereqeieleslessaiqantiemepartidecestecontree.	jeferaiceqejetevoidesirrer.portavolontéacomplir.mesjetepriqetumediesselievesqedecestecontree.sontdautelmaniereqejeleslessaiqantjemepartidecestecontree.
lors	lors
respondi	respondi
ie	je
onqesnedemandetelchosesetulasuraiem̅toiseucaraussibienlesestuꝯmeie,sicomiecuitetsetunelesesnulechosenestmiudreaoirneaentendre.cenepuisiemietereqeienetedieracontetantsolement:delachosetantcomilenest.uniotdeseuesqesqiplusaspresfudensiureseintesoeuresqeliautre,sicomielesaibiencariefuiensambleoluiadessilamaisortotescreatures.etqantilmesouientdeluidesesoeures,grantdolormepointaucuerporcequilnadeguerpizlessiez.etiemesmerueilconmentilfusinostreamis:puissinousdeguerpientelemaniere.mesporceqilnestoremieneleusnetens:deconterchosesqifacentaplorerteprieieqetunosracontesceqetunosauoiespromisadiresilorronsentenderons.	onqesnedemandetelchosesetulasvraiementoïetseücaraussibienlesestuconmeje,sicomjecuitetsetunelesesnulechosenestmiudreaoïrneaentendre.cenepuisjemietereqejenetedieetracontetantsolement:delachosetantcomilenest.uniotdesevesqesqiplusaspresfudensivreseintesoevresqeliautre,sicomjelesaibiencarjefuiensambleoluiadésetsilamaisortotescreatures.etqantilmesovientdeluietdesesoevres,grantdolormepointaucuerporcequilnosadeguerpizetlessiez.etjemesmerveilconmentilfusinostreamis:etpuissinousdeguerpientelemaniere.mesporceqilnestoremieneleusnetens:deconterchosesqifacentaplorertepriejeqetunosracontesceqetunosavoiespromisadiresilorronsetentenderons.
postumiens	postumiens
respondi	respondi
ensiuoelieqilsoit.	ensivoeljeqilsoit.
qant	qant
il	il
ot	ot
ce	ce
dit	dit
nos	nos
nos	nos
te	te
umes	ümes
feimes	etfeïmes
pessi	pessi
escoutames	escoutames
il	etil
trest	trest
son	son
siege	siege
seur	seur
qoi	qoi
il	il
seoit	seoit
pluspres	pluspres
de	de
moi	moi
si	si
comenca	comença
aparler	aparler
entel	entel
maniere	maniere
ora.iii.anzqeiemedepartidetoiietoisalueqeieentraienmeranerbonesicorumestantadroitesuoilescroisiesapropreuentbondroit.qinosferoitenlapopedenostrenefsanztormentsanztempeste:tantqeauquintiorgetamesnosancreselportdaufriqe.delasinosplotparlauolontédenostresignoraalerencartage.uisiterlesliusdesseinz.meesmementlasopouturedeseintcẏprienporaorerfeirenozorissonssicomresonsestdroiture.etquantuintauquinziemeiorqenoseumeslademorenosreuenimesauport,sientramesennoznef.etqantnfumesdeꝑtidelaterre.nozuoilesestoientestenduzporcorreenalixandreunsuēztrauersainsnosuintqiamoltpresnottormentezperizmeslimarinierqisageestoient:geterentlorancrescarlaterrenaparoitauquesprocainequantlatempestefutrespasseenosissimesenlisledecaphseounosnetrouamesguairesdegarisonsqibonesnosfussent.etieqiplusfuiententisdesautresaschosesdelisleaenqerremepartidemescompaignons.sialai.iii.bonesliuesensusdelriuage.porcerchierenqerreseieaucuneauentureitroueroie.ienoimieloingaleqantieitrouaiunpetithabitacle.ceestunepetitemesonqidaisestoitfete.couertenonmieporceqeledoutastpluiecaronsneplutenlacontreemesgranzuensiuenoientparpluiseursfoizhisdeus.ilniauoitarbresneblezqisemeifussent.qeliuenznesrachassentmesenluneꝑtiedelaterreauoitmontaignesdeuerslamerqilesuenzarrestoient.laencontrecroissoitherbedontlesbrebizdelacontreeauoientpouturecilqienceleterrehabitoient:uiuoientdeletdepeindorgelacostumesiestoitteleenceleisle:qeqantlasemenceestoitsorlaterreespandueqeleestoitautrētiesmeiormeure.etcilqihabitoientenceleterre.niarrestoientporautrechose:qeporceqiliestoientcuitedetoztreusdeliures.etceleterreestoitladaerrienedelacontreedecẏrene⁊siestoitmoltprocheinedelentreedesdeserz:qisontentreaufriqeegẏpte.parouchatonssenfoiensambleosonostqantildeguerpisacontree.porcesarqiuoloitaforceauoirlempirederome.dontpompeusfumorzsicomlucanstesmoigne.lorsmenalaialabitacleqeieueuauoie,sitrouaiunuielhomeuestudunepelicesimoloitorgeaunemeinmole.qantiecilqiensambleomoiestoientleumessalueilnosrecutmoutbenignementsifumoutliezdenostreuenue.noslideismes:qeuenznosauoientamenezencestriuage:qencoreatendionsuentcouignableporentrerenmerralerennostreuoie.aprescelidemandameslanaturedelat̉rredeceusqiihabitoient:siliauoitnulcrestiencarnosestionscrestienaussint.qantliuielzhomoiceilꝯmencaaplorerdeioiesiselessacheoiranospiez.quantilnosotmoutbesiezilnosꝯmandaaferenosorisōsanostresignor.apressiestendisorterrepiaꝰdemoutonssinosfistasseoirdeseure:puissinosaportaamengier.teluiandecomnostresiresliauoitdoneelamoitiedunpeindorge.unfaisseletduneerbedontiaioublielenonmesdoucechoseestoitdelasaueurdemiel.nousqatreiestionslipreudomliquinssimeniamesfumesreplenisaouleparladoucordeceleherbe.qimoutestoitbonedelitable.	ora.iii.anzqejemedepartidetoietjetoisaluéqejeentraienmeranerbonesicorumestantadroitesvoilescroisiesapropreventbonetdroit.qinosferoitenlapopedenostrenefsanztormentetsanztempeste:tantqeauquintjorgetamesnosancreselportdaufriqe.delasinosplotparlavolontédenostresignoraalerencartage.etvisiterlesliusdesseinz.etmeesmementlasopouturedeseintcyprienporaoreretfeirenozorissonssicomresonsestetdroiture.etquantvintauquinziemejorqenoseümeslademorénosrevenimesauport,sientramesennoznef.etqantnosfumesdepartidelaterre.etnozvoilesestoientestenduzporcorreenalixandreunsvenztraversainsnosvintqiamoltpresnosottormentezetperizmeslimarinierqisageestoient:geterentlorancrescarlaterrenosaparoitauquesproçainequantlatempestefutrespasseenosissimesenlisledecaphseounosnetrovamesguairesdegarisonsqibonesnosfussent.etjeqiplusfuiententisdesautresaschosesdelisleaenqerremepartidemescompaignons.etsialai.iii.bonesliuesensusdelrivage.porcerchieretenqerresejeaucuneaventureitroveroie.jenoimieloingaléqantjeitrovaiunpetithabitacle.ceestunepetitemesonqidaisestoitfete.etcovertenonmieporceqeledoutastpluiecaronqesneplutenlacontreemesgranzvensivenoientparpluiseursfoizethisdeus.ilniavoitarbresneblezqiseméifussent.qelivenznesrachassentmesenlunepartiedelaterreavoitmontaignesdeverslamerqilesvenzarrestoient.laencontrecroissoitherbedontlesbrebizdelacontreeavoientpoutureetcilqienceleterrehabitoient:vivoientdeletetdepeindorgeetlacostumesiestoitteleenceleisle:qeqantlasemenceestoitsorlaterreespandueqeleestoitautrentiesmejormeüre.etcilqihabitoientenceleterre.niarrestoientporautrechose:qeporceqiliestoientcuitedetoztreusetdelivres.etceleterreestoitladaerrienedelacontreedecyreneetsiestoitmoltprocheinedelentreedesdeserz:qisontentreaufriqeetegypte.parouchatonssenfoïensambleosonostqantildeguerpisacontree.porcesarqivoloitaforceavoirlempirederome.dontpompeusfumorzsicomlucanstesmoigne.lorsmenalaialabitacleqejeveüavoie,sitrovaiunvielhomevestudunepelicesimoloitorgeaunemeinmole.qantjeetcilqiensambleomoiestoientleümessaluéilnosreçutmoutbenignementetsifumoutliezdenostrevenue.etnoslideïsmes:qevenznosavoientamenezencestrivage:etqencoreatendionsventcovignableporentrerenmeretralerennostrevoie.apréscelidemandameslanaturedelaterreetdeceusqiihabitoient:etsiliavoitnulcrestiencarnosestionscrestienaussint.qantlivielzhomoïceilconmençaaplorerdejoiesiselessacheoiranospiez.quantilnosotmoutbesiezilnosconmandaaferenosorisonsanostresignor.apréssiestendisorterrepiausdemoutonssinosfistasseoirdeseure:etpuissinosaportaamengier.telviandecomnostresiresliavoitdoneelamoitiédunpeindorge.etunfaisseletduneerbedontjaioubliélenonmesdoucechoseestoitetdelasaveurdemiel.nousqatreiestionsetlipreudomliquinssimenjamesetfumesreplenietsaouléparladouçordeceleherbe.qimoutestoitboneetdelitable.
qant	qant
ie	je
seuerus	severus
oi	oï
dire	dire
postumien	postumien
telchose	telchose
ie	je
comencai	començai
asorriresi	asorriresi
dis	dis
a	a
gaullum	gaullum
mon	mon
compaignon	compaignon
galle,qetensambledontnefu-cebonsdemipeinsdorge:boneherbedont.v.homefurentsaouleentelmaniere	galle,qetensambledontnefu-cebonsdemipeinsdorge:etboneherbedont.v.homefurentsaouléentelmaniere
dont	dont
en	en
ot	ot
postumiens	postumiens
un	un
pou	pou
de	de
uergoignepor	vergoignepor
ce	ce
qil	qil
me	me
uit	vit
sorrire	sorrire
si	si
nos	nos
dist	dist
jemestoiepenseqeieuraconteroielesuiandesqecilhomnauoitdoneespar.vii.iorz:qenosensambleoluifusmesmesiementargeraioreqegallusnensoitanuiezpartroplongueparole:siuosconteraiapresceqenosfeimes.apresceqeliiorzlanuitfutrespassee:liautresiorzfuuenuznesaiqanzdecelsqienceleislehabitoient.uindrentalhabitacledelpreudomepornosuisiter.cilnosdistrentqenostreostesestoitprestrescarillenosauoitbiencelenefetnenosenauoitdemostrance.apsenalamesaleglisse.qipresde.ii.liuesestoit.loingdesonhabitacle.siestoittoteauirōneedunemontaigneenclose.faitesibassedeoeuresdeuergesqapainesipooitnushomesterdroizensonestant.qantliseruicesfufeznosleumesoientendunosenrepeiramesensambleonostreostesescompaignonssidemandamesdescostumesdesgenzdelaterre.etilnosdistrent:qilneuendoientnenachatoient.nenauoientorneargent:nenesauoientriensdelarrecīnedeboisdie:neneuoloientnenedesirroiētaauoirnedeniersnemonoiecarqantieuoildoneranostreoste.x.besanzilnenuoltnulprendreeinziuraqepororneporargētneporroiteglisseenlaterrefeteneestoreemesseilestoitdedenzmiselleenseroitdestruite.dontdonamesanostreosteceqenpeumessoffrirdenosuesteures:illesrecutmoutbenignement.lorsnosremanderentlinotonierauriuage.nospartimesdenostreostesinosenralamesanosnes.qantnosfumesdedenzrentrelimariniertraistrentlorancressidrecierentloruoilesesmasliuenzsiferiqitostnosotesquipezdelacontree.	jemestoiepenséqejevosraconteroielesviandesqecilhomnosavoitdoneespar.vii.jorz:qenosensambleoluifusmesmesjementargeraioreqegallusnensoitanuiezpartroplongueparole:etsivosconteraiaprésceqenosfeïmes.aprésceqelijorzetlanuitfutrespassee:etliautresjorzfuvenuznesaiqanzdecelsqienceleislehabitoient.vindrentalhabitacledelpreudomepornosvisiter.etcilnosdistrentqenostreostesestoitprestrescarillenosavoitbiencelénefetnenosenavoitdemostrance.aprésenalamesaleglisse.qipresde.ii.liuesestoit.loingdesonhabitacle.etsiestoittoteavironneedunemontaigneetenclose.etfaitesibassedeoevresdevergesqapainesipooitnushomesterdroizensonestant.qantliservicesfufezetnosleümesoïetentendunosenrepeiramesensambleonostreosteetsescompaignonssidemandamesdescostumesdesgenzdelaterre.etilnosdistrent:qilnevendoientnenachatoient.nenavoientorneargent:nenesavoientriensdelarrecinnedeboisdie:nenevoloientnenedesirroientaavoirnedeniersnemonoiecarqantjevoildoneranostreoste.x.besanzilnenvoltnulprendreeinzjuraqepororneporargentneporroiteglisseenlaterrefeteneestoreemesseilestoitdedenzmiselleenseroitdestruite.dontdonamesanostreosteceqenospeümessoffrirdenosvesteüres:etillesreçutmoutbenignement.lorsnosremanderentlinotonieraurivage.etnospartimesdenostreostesinosenralamesanosnes.qantnosfumesdedenzrentrélimariniertraistrentlorancressidrecierentlorvoilesesmaslivenzsiferiqitostnosotesquipezdelacontree.
einsintenalames.tantqau.vii.imeioruenimesenalixandre.laauoitentreleseuesqeslesmoignesdelaterre.granztenconsgranzdesputisonsdesliuresorigeneporceleochoisonmedeꝑtiiedalixandre.sialaitantqeieuīgenbethleemunchastelqiesta.vi.liuespresdeierusalem.adontengouernoitleglisseseinzieromesestoitprestresmestes,carceestuneparrocealeuesqedelacitedeierusalemcilieromesestoitmoltpreudōmoutseinzhomensigniezendoctrinezdelatin.degreu.debreusiqilnestoitnusqisepeustaparellierasascienceparclergie.etiememerueilmout.seuosnauezoideluiparlerparlesescrituresqilafeites	einsintenalames.tantqau.vii.imejorvenimesenalixandre.laavoitentrelesevesqesetlesmoignesdelaterre.granztençonsetgranzdesputisonsdeslivresorigeneetporceleochoisonmedepartijedalixandre.sialaitantqejevingenbethleemunchastelqiesta.vi.liuespresdejerusalem.adontengovernoitleglisseseinzjeromesetestoitprestresetmestres,carceestuneparrocealevesqedelacitédejerusalemetciljeromesestoitmoltpreudometmoutseinzhometensigniezetendoctrinezdelatin.etdegreu.etdebreusiqilnestoitnusqisepeüstaparellierasascienceparclergie.etjememerveilmout.sevosnavezoïdeluiparlerparlesescrituresqilafeites
gallus	gallus
dist	dist
uoirementenauomnosbienoitparler.sileconoissonscarencorenamie.v.anzqeieliucenunsienliureqilauoittretiefait.ouilreprenoitmolttoutelanasciondesmoignes:belguisunsnostrecompainssesoloitmoltcorrocierdeceqeliliuresdisoitqelimoignesmengoienttropmescedisoitildeceusdorienteincoisqedeceusdoccident.etneqedentilreprenoittoutesautresgenzdauaricedorgueil:detozautresuices.	voirementenavomnosbienoïtparler.etsileconoissonscarencorenamie.v.anzqejeliuçenunsienlivreqilavoittretiéetfait.ouilreprenoitmolttoutelanasciondesmoignes:etbelguisunsnostrecompainssesoloitmoltcorrocierdeceqelilivresdisoitqelimoignesmengoienttropmescedisoitildeceusdorienteinçoisqedeceusdoccident.etneqedentilreprenoittoutesautresgenzetdavariceetdorgueil:etdetozautresvices.
postumiens	postumiens
dist	dist
jefuiensambleolui.v.moissiqilauoitsouētbatailleencontrelesmalueshomesliheritelehaoientporceqillorblasmoittotadeslormalueseserrances.delamedeꝑtiiesimenuingenalixandreqantieioimesfreresuisitez:qiiarrestoientiemēalaiesdaerreinierespartiesdegẏptelatrouaiieesdeserzenlermitagepluisorsmoignesqiimanoient.preudomeseīthomeestoient.	jefuiensambleolui.v.moissiqilavoitsoventbatailleencontrelesmalvéshomesetliheritelehaoientporceqillorblasmoittotadéslormalveseserrances.delamedepartijesimenvingenalixandreqantjeioimesfreresvisitez:qiiarrestoientjemenalaiesdaerreinierespartiesdegyptelatrovaijeesdeserzenlermitagepluisorsmoignesqiimanoient.etpreudomeetseinthomeestoient.
longechoseseroitderaconterdedireceqeieiui.mesneqedentieuosconteraiunpetitdepluiseurᷤchosesqeieiaiueues.presdelermitagesorlariuieredelnilsiapluisorsabeies.teleiaouilacentmoignesenteleiameinzenteleiaplus.siuiuentsoloncleꝯmandementdelorabequanqilfontceestparlorabeteleestlorriule.etcilqiplusgnͣtuertuonteneus:qilorcuersontmielzesprouez.nesenpuentꝑtirnealerenlermitage.pormeneruiesolitaireseparleꝯmandementnondelorabe.etcestlorpremeraineuertuqilleissentloruolentezporautruiuoloirsaemplirfeire.etqnͣtaucunsenestissusparuolentedesonabeporalerenlermitagemanoirliabbeslienuoiepeinautreuiandetelecomluiplestdontsescorspuistestresostenuz.adontqantiefuilauenuzenceleterre,ieitrouaiꝑauentureundeusqienlermitageestoitalezmanoirnouelementsiauoitsonhabitaclefetestabli:pourmeneruiesolitaireloingdelabeiedontilestoitissuspresde.vi.luies.etlienuooitliabbes.trametoitpeinpar.ii.enfanzsicomilestoitlorusages.lienfantqilaestoientuenulepainaporteauoient:nestoientmiedegrantaagecarliainsneznauoitqe.xv.anz.liautres.xii.anz.sicomilsenrepairoientlauoieqilestoientuenuzunsgranzserpenzloruintalencontreqimoltestoithisdeusoribles.qantlienfantleuirent,ilnenorentnulepoor.liserpenzuinttresqedeuantlorpiezsibessalecollatesteaussiꝯmesilfustenchantezꝑcharmes.lorslepristlimendres,silencomencaamenerensambleolui.silifistportersasfubleure.qantilentraenlabeie,ildemenagrantioieaussiꝯmesileustlabesteueincue.etdontledesliadesasfubleureqisorliestoitsilenlessaalerdeuanttrestozsesfreresqilesgardoiēt.dōtcomencierenttuitlifreredelabeieadireliunsalautre:quelienfantestoientengrantuertu.qantliabbessotcestechoseilneuoutmieqelienfantsenorguellesissentsilesbatideuergesmoltdurement.etpuissilordistporceqilauoientdemostreloeureqenostresiresauoitporeusfet.bienlordistqilseussentqeceleoeurenestoitmieparlorfetmeᷤꝑladiuinepuissance.etbienentendissentqelendoitnostresignorseruirenhumilite,nonmiegloirefieressignesneesuertuz.qantcestechosefueinsinttrespasseeliseinzhomlesotacuilienfantauoientlepainaporteilfumlt̉dolenzporceqeliabbeslesauoitbatuzporlemiracleqenostresignorauoitpoureusfaitsidesfendialabbeqedesoreenauantnelienuoiastnepeinneuiande	longechoseseroitderaconteretdedireceqejeivi.mesneqedentjevosconteraiunpetitdepluiseurschosesqejeiaiveües.presdelermitagesorlarivieredelnilsiapluisorsabeïes.teleiaouilacentmoignesenteleiameinzenteleiaplus.etsiviventsoloncleconmandementdelorabéetquanqilfontceestparlorabételeestlorriule.etcilqiplusgrantvertuonteneus:etqilorcuersontmielzesprovez.nesenpuentpartirnealerenlermitage.pormenerviesolitaireseparleconmandementnondelorabé.etcestlorpremerainevertuqilleissentlorvolentezporautruivoloirsaempliretfeire.etqantaucunsenestissusparvolentédesonabéporalerenlermitagemanoirliabbeslienvoiepeinetautreviandetelecomluiplestdontsescorspuistestresostenuz.adontqantjefuilavenuzenceleterre,jeitrovaiparaventureundeusqienlermitageestoitalezmanoirnovelementsiavoitsonhabitaclefetetestabli:pourmenerviesolitaireloingdelabeïedontilestoitissuspresde.vi.luies.etlienvooitliabbes.ettrametoitpeinpar.ii.enfanzsicomilestoitlorusages.lienfantqilaestoientvenuetlepainaportéavoient:nestoientmiedegrantaagecarliainsneznavoitqe.xv.anz.etliautres.xii.anz.sicomilsenrepairoientlavoieqilestoientvenuzunsgranzserpenzlorvintalencontreqimoltestoithisdeusetoribles.qantlienfantlevirent,ilnenorentnulepoor.etliserpenzvinttresqedevantlorpiezsibessalecoletlatesteaussiconmesilfustenchantezparcharmes.lorslepristlimendres,silencomençaamenerensambleolui.etsilifistportersasfubleüre.qantilentraenlabeïe,ildemenagrantjoieaussiconmesileüstlabesteveincue.etdontledesliadesasfubleüreqisorliestoitsilenlessaalerdevanttrestozsesfreresqilesgardoient.dontcomencierenttuitlifreredelabeïeadireliunsalautre:quelienfantestoientengrantvertu.qantliabbessotcestechoseilnevoutmieqelienfantsenorguellesissentsilesbatidevergesmoltdurement.etpuissilordistporceqilavoientdemostréloevreqenostresiresavoitporeusfet.etbienlordistqilseüssentqeceleoevrenestoitmieparlorfetmesparladivinepuissance.etbienentendissentqelendoitnostresignorservirenhumilité,nonmiegloirefieressignesneesvertuz.qantcestechosefueinsinttrespasseeetliseinzhomlesotacuilienfantavoientlepainaportéilfumoutdolenzporceqeliabbeslesavoitbatuzporlemiracleqenostresignoravoitpoureusfaitsidesfendialabbéqedesoreenavantnelienvoiastnepeinneviande
einsifuliseinzhom.viii.iorzqeonqesnemengasiꝯmencierētsesmembresmoltaamaigrir:porlafaminemessauraiepenseenalaschoitonqes:qianostresignorestoitentētiue.sescorsalassoitporceqilnauoituiandemeslafoiqierturaieenluifermeduroitsanzochoison.dontuintliabbesꝑlauolentedelseintesperitalui:pordemanderqeluieiluoudroitmenerqilnelessoitqepeinslifustaportezparnulhome.qantciluitlabbeuenirilcouruencontre,silirendigracesdeceqilleuenoituisitersilenmenaasacelleetsicomilentroientdedenzambeduiensābleiluirentuncorbellonpendrealentreedelhuis.sisentirentqeodeursdechautpeinenissoit.puissiregarderentsiletrouerentaussintcomsilfustmeintenanttrezhorsdelfeumesilnauoitmieformenesamblancedepeindelacontreedōtfurentanduiesbahisisorentbienconurentqeceestoitdonsdenostresignor.dontdistliseinzhomalabbeqenostresireᷤliauoitenuoieporsauenueetliabbesdisoitqenonauoiteinzestoitporlauertuporlafoiqilauoitenlujlorssassistrēt,simengierentpargrantioie.celpeinqenostresireslorauoitenuoie.aprespristcongieliabbes,sisenreuintenlabeie.ilracontaasesfrerescestmiracleqilauoitueu.dontfurentilsiesmeuzenlorcoragesdelamournostresignor:qildistrentqilestoiētmoltchetifqantilensamblesetenoient.ouilauoienthumeinecompaignie.dontsenpartirentpluisoralerentenlermitagepormeneruiesolitaire.etiemedeꝑtidelasimenentraienlapremeraineꝑtiedeldesert.oulihermitehabitoientetceestoitloingdelariuieredelnilpriesde.xii.liues.siauoitensambleomoiundesfreresdelacontree.qimoltbiensauoitlesdeserzlermitage.cilmemenaꝑtozlesleusqidiuersestoientounosueimesplusorschoseᷤ.	einsifuliseinzhom.viii.jorzqeonqesnemengasiconmencierentsesmembresmoltaamaigrir:porlafaminemessavraiepenseenalaschoitonqes:qianostresignorestoitententive.sescorsalassoitporceqilnavoitviandemeslafoiqiertvraieenluietfermeduroitsanzochoison.dontvintliabbesparlavolentédelseintesperitalui:pordemanderqelvieilvoudroitmenerqilnelessoitqepeinslifustaportezparnulhome.qantcilvitlabbévenirilcouruencontre,silirendigracesdeceqillevenoitvisitersilenmenaasacelleetsicomilentroientdedenzambeduiensambleilvirentuncorbellonpendrealentreedelhuis.etsisentirentqeodeursdechautpeinenissoit.puissiregarderentsiletroverentaussintcomsilfustmeintenanttrezhorsdelfeumesilnavoitmieformenesamblancedepeindelacontreedontfurentanduiesbahietsisorentbienetconurentqeceestoitdonsdenostresignor.dontdistliseinzhomalabbéqenostresiresliavoitenvoiéporsavenueetliabbesdisoitqenonavoiteinzestoitporlavertuetporlafoiqilavoitenluilorssassistrent,simengierentpargrantjoie.celpeinqenostresiresloravoitenvoié.apréspristcongiéliabbes,sisenrevintenlabeïe.ilracontaasesfrerescestmiracleqilavoitveü.dontfurentilsiesmeüzenlorcoragesdelamournostresignor:qildistrentqilestoientmoltchetifqantilensamblesetenoient.ouilavoienthumeinecompaignie.dontsenpartirentpluisoretalerentenlermitagepormenerviesolitaire.etjemedepartidelasimenentraienlapremerainepartiedeldesert.oulihermitehabitoientetceestoitloingdelarivieredelnilpriesde.xii.liues.siavoitensambleomoiundesfreresdelacontree.qimoltbiensavoitlesdeserzetlermitage.cilmemenapartozlesleusqidiversestoientounosveïmesplusorschoses.
tantalamesqenostrouamesiuielmoine.qihabitoitenunefosseaupiedunegrantmontaigne:laauoitunpuis:dontiliauoitpetitentrestozlesdeserzcarienecuitqueilenieust.ii.autresentoutlermitageciluielzhomauoitunbueftantsolem̅tqinefaisoitautrechoseentoztens:qetrereleauedelpuisparlengienduneroeqiatorneeiestoitacefeireauoitlibuesasseztrauailcarlipuisauoitplusdemilpiezdeparfont.deuantcelpuisauoituncortilqitozestoitpleinzderbesqeliuielzhomauoitsemeescemeesmesestoitcontrelanaturedeldesertdelhermitagecarlagrantchaleurdelsoleillaterreqiestoitarsesechenilessoituenirnulesemenceneautrechoseqiuerdeureuistneracinemesligranztrauausdelseinthomeqilamanoitdesabeste.donoitalaterrenorretureparceqillarosoittoutadesdeleaue.qidelpuisestoittraite.etnousnosesmerueillamesmoutqantnosueimeslecortilsireplenisicharchiedebelesherbesdeuerdescouleurs.decesherbestantseulem̅tuiuoitliseinzhomsabestedecemeismesnosdonaliseinzhomamengier.etlauicietelchose,galleqetuꝑauenturenecreroiesmiecarieuilepotatoteslesherbesqenosdeuionsmengierbolirsanzfeucarlaforcedelsoleiliestsigranzlachaleurs.quelesousfiroitbienacuirelesuiandesdecestecontree.qantnoseusmesmengieuespresestoitiaauqueᷤaprochieilnosdemādasenosuolionsaleresbanoieraunarbrequipomiersanonqipresdiluecestoita.ii.liues.delfruitdecelarbremengoitilalafoie.dontnosmeumestuittroisinosenalamesacelarbre.poresbanoierporueoirsamanierecarautresarbresnailenlermitage.deceusmeismesmlt̉petit.neqedentséiediredontiluienentnecomentseilnaissentdelanatͧedelsoleildelachaleur:ousenostresiresqiseitleschosesancoisqelesauiegnentlesifaissoitnestreaoeslesseinzhermitesqisiserfestoientqiencesleushabiterdeuoientcargranzpartiesdesseinzhomesqihabitentesparfonsdeserz.uiuētdesfruisdecesarbres.etqantnosfusmesuenuzaceluiarbreounosseinzostesnosmenoitnosiueimesungrantlion.qidesozestoitarrestezporleserainporlafroidure.qantieleuimescompeinznoseneumessigrantpoorqenosentramblamestuit.liseinzhom,nostreostes,alaauantsanzdotance.nosleꝯmencamesasiuirmoutpoorosement.doncꝯmandaliseinzhomalabesteq̉lesedepartisistdiluecelesetrestloingdelarbre.doncsarrestatantqeliseinzhomeustcuellidelfruit.ettantostcomellelenuittenirensameinsiacorutauantliseinzhomlendona.labestelepristaussibelementcomuneautrebestebiendontee.etqanteleenotmengieelesenpartitintsauoie.nousqicouesgardamestuitpooreus:peumesbiensauoirentendreqeelseinthomeauoitmoutdeuraiefoideuertuqeennosauoitmoltdenfermetedelacharhumeine.dontnosdepartimesdela.	tantalamesqenostrovamesunvielmoine.qihabitoitenunefosseaupiédunegrantmontaigne:etlaavoitunpuis:dontiliavoitpetitentrestozlesdeserzcarjenecuitqueilenieüst.ii.autresentoutlermitagecilvielzhomavoitunbueftantsolementqinefaisoitautrechoseentoztens:qetrereleauedelpuisparlengienduneroeqiatorneeiestoitetacefeireavoitlibuésasseztravailcarlipuisavoitplusdemilpiezdeparfont.devantcelpuisavoituncortilqitozestoitpleinzderbesqelivielzhomavoitsemeesetcemeesmesestoitcontrelanaturedeldesertetdelhermitagecarlagrantchaleurdelsoleiletlaterreqiestoitarseetsechenilessoitvenirnulesemenceneautrechoseqiverdeureuïstneracinemesligranztravausdelseinthomeqilamanoitetdesabeste.donoitalaterrenorretureparceqillarosoittoutadésdeleaue.qidelpuisestoittraite.etnousnosesmerveillamesmoutqantnosveïmeslecortilsireplenietsicharchiédebelesherbesdeverdescouleurs.decesherbestantseulementvivoitliseinzhometsabesteetdecemeïsmesnosdonaliseinzhomamengier.etlaviçjetelchose,galleqetuparaventurenecreroiesmiecarjevilepotatoteslesherbesqenosdevionsmengierbolirsanzfeucarlaforcedelsoleiliestsigranzetlachaleurs.quelesousfiroitbienacuirelesviandesdecestecontree.qantnoseüsmesmengiéetvespresestoitjaauquesaprochiéilnosdemandasenosvolionsaleresbanoieraunarbrequipomiersanonqipresdiluecestoita.ii.liues.etdelfruitdecelarbremengoitilalafoie.dontnosmeümestuittroisinosenalamesacelarbre.poresbanoieretporveoirsamanierecarautresarbresnailenlermitage.etdeceusmeïsmesmoutpetit.neqedentséjediredontilvienentnecomentseilnaissentdelanaturedelsoleiletdelachaleur:ousenostresiresqiseitleschosesançoisqelesaviegnentlesifaissoitnestreaoéslesseinzhermitesqisiserfestoientqiencesleushabiterdevoientcargranzpartiesdesseinzhomesqihabitentesparfonsdeserz.viventdesfruisdecesarbres.etqantnosfusmesvenuzaceluiarbreounosseinzostesnosmenoitnosiveïmesungrantlion.qidesozestoitarrestezporleserainetporlafroidure.qantjelevietmescompeinznoseneümessigrantpoorqenosentramblamestuit.etliseinzhom,nostreostes,alaavantsanzdotance.etnosleconmençamesasivirmoutpoorosement.doncconmandaliseinzhomalabesteqelesedepartisistdiluecetelesetrestloingdelarbre.etdoncsarrestatantqeliseinzhomeüstcuellidelfruit.ettantostcomellelenvittenirensameinsiacorutavantetliseinzhomlendona.etlabestelepristaussibelementcomuneautrebestebiendontee.etqanteleenotmengiéelesenpartiettintsavoie.nousqiçouesgardamestuitpooreus:peümesbiensavoiretentendreqeelseinthomeavoitmoutdevraiefoietdevertuetqeennosavoitmoltdenfermetédelacharhumeine.dontnosdepartimesdela.
quantuintalamatineesinenalamessitrouamesunautreseinthomesamblantacestuisicomieuconteraiꝑbriefparole.cilseinzhommanoiteldesertenunpe--tithabitaclesiestroitqeduinipeussētmiegesirensamble.uneleuuesiestoitacostumeeqeleuenoittoztensauseinthomealeureqilmengoit.nenepooitonqesdeleuredeceueestreqeleniuenistapointatans.etlorssecouchoitalentreedelamaissoncele.tresqatantqeliseinzhōlidonoitlesmietesdepeinaussintꝯmedereliefqiremanoit.etqantillidonoitamengier,lalouuelilechoitlesmeinzsisendeꝑtoit.mesuniorauintꝑauentureqeliseinzhomconuoiaunsienfrereqiuenuzlestoitueoirsinerepairatresqatantqelanuizfuuenue.cidedenzreuintlabestealeureqeleestoitacostumeesinetrouamiedesonsignͬdedenzlabitacle.elelequistpartout.qantellenelepottrouerelleuituncorbellondunepartenunanglepend.enqoiilauoit.v.peins.qisiꝯmeiecroiestoientdorge.lalouueempristlun,silemenga.etqantelleotfaitcelefelonie,sisedepartidelacele,sitintsauoie.lihermitesrepairasiuitsoncorbellondesliedelaouillauoitatachie.nenetrouamiedesonpeinleconte.dontsotilbienconliauoitfaitdamagemesilnesauoŧqietsitrouaillesmieteslaoulaloueauoitmengiedelpeinalentreedelacele.mesqantuintlendemeinlabestequisauoitbienqeleauoitmesfeitnefutanthardieqelereuenistneausecontiorneautierzlihermitessienfumoltdolenzporceqilauoitperduesacompaignie.audaerreinenfistilsorissonanostresignor.qillirendist,saluiplaisoit,seleestoitenuieremese.qantuintapresleseptimeiorlabestereuintaumengierdelseinthomesicomeleestoitdeuantacostumee.etqanteleuitleseinthomeuospeussiezueoir,seuosifussiez,qeleauoituergoignedeceqelemesfetauoitqelesenrepentoit.elenosoitauantaproismierneamontesgardereinzauoitsaueueuersterreabessie.sisembloitqelereqeistꝑdonparlesigneqelefaisoit.quantlihermiteslauitsidolenteillaꝯmandaauantuenirsiliꝯmencaasameinaaplanoierlatestepuissilidona.ii.tansdepeinqilnesoloit.einsiotleleuuelepardondelseinthermite.etporceqenesamblechosemalcreableqeieuosaidite,ieuosconteraiplusgrantmerueilleplusgrantmiracle.etcesacedexqeieneuosꝯtrouereinulechoseneneuosconteraisecenonqeieaiueu:ouoidireraconterdesseinzhomesqilendoitbiencroire.	quantvintalamatineesinosenalamessitrovamesunautreseinthomesamblantacestuisicomjevosconteraiparbriefparole.cilseinzhommanoiteldesertenunpe--tithabitaclesiestroitqeduinipeüssentmiegesirensamble.uneleuvesiestoitacostumeeqelevenoittoztensauseinthomealeureqilmengoit.nenepooitonqesdeleuredeceüeestreqelenivenistapointetatans.etlorssecouchoitalentreedelamaissoncele.tresqatantqeliseinzhomlidonoitlesmietesdepeinaussintconmedereliefqiremanoit.etqantillidonoitamengier,lalouvelilechoitlesmeinzsisendepartoit.mesunjoravintparaventureqeliseinzhomconvoiaunsienfrereqivenuzlestoitveoirsinerepairatresqatantqelanuizfuvenue.etcidedenzrevintlabestealeureqeleestoitacostumeesinetrovamiedesonsignordedenzlabitacle.elelequistpartout.etqantellenelepottroverellevituncorbellondunepartenunanglependre.enqoiilavoit.v.peins.qisiconmejecroiestoientdorge.lalouveempristlun,silemenga.etqantelleotfaitcelefelonie,sisedepartidelacele,sitintsavoie.lihermitesrepairasivitsoncorbellondesliédelaouillavoitatachié.nenetrovamiedesonpeinleconte.dontsotilbienconliavoitfaitdamagemesilnesavoitqietsitrovaillesmieteslaoulaloveavoitmengiédelpeinalentreedelacele.mesqantvintlendemeinlabestequisavoitbienqeleavoitmesfeitnefutanthardieqelerevenistneausecontjorneautierzlihermitessienfumoltdolenzporceqilavoitperduesacompaignie.audaerreinenfistilsorissonanostresignor.qillirendist,saluiplaisoit,seleestoitenvieremese.qantvintaprésleseptimejorlabesterevintaumengierdelseinthomesicomeleestoitdevantacostumee.etqantelevitleseinthomevospeüssiezveoir,sevosifussiez,qeleavoitvergoignedeceqelemesfetavoitetqelesenrepentoit.elenosoitavantaproismierneamontesgardereinzavoitsaveüeversterreabessie.etsisembloitqelereqeïstpardonparlesigneqelefaisoit.quantlihermiteslavitsidolenteillaconmandaavantvenirsiliconmençaasameinaaplanoierlatesteetpuissilidona.ii.tansdepeinqilnesoloit.einsiotleleuvelepardondelseinthermite.etporceqenesamblechosemalcreableqejevosaidite,jevosconteraiplusgrantmerveilleetplusgrantmiracle.etcesacedexqejenevoscontrovereinulechosenenevosconteraisecenonqejeaiveü:ouoïdireetraconterdesseinzhomesqilendoitbiencroire.
pluiseurshermiteshabitoientenlermitageqinontmiecelesnehabitaclesouilarrestentonquescelsapelentilanacorintes.ciluiuentderbesderacinessinarrestentonqespormanageenunseulleuporceqeilneuoelentqenulesgenzleshantētmeslaoulanuitlesprentarrestentiltresqalendemeinalaiorner.sontadesenorissonsenproieres.unenauoitenceldesertdecelemaniereqimoltestoitseinzhomcuiduimoinedelacontreedenitreqimoltestoitdiuerseterreloīgassise.uindrentqerreporlesuertuzporlaseinteeqiloirentdeluiraconterdirecarilauoitestemoltlorꝯpeinsloramisenlorabeie.qantiluindrētenlermitage,sileꝯmencierentaquerremoltlongementtantqa.vii.moisletrouerentesdaerrainespartiesdesdeserz.laauoitliseinzhermiteshabite.xii.anzꝑcespartiesqimoltestoientoriblessauuages.etiafustceqilneustcuredelacōpaigniedenulhomeilnesenfujmieqnͣtiluitcelsqilconoissoiteinzfuensambleoeusꝑtroisiors.leurcontapluiseurschoses.auqartiorqnͣtilorentprisꝯgieliseinzhomlesꝯmencaaconuoierꝑlagrantdesertine.etsiꝯilaloientensamble,iluirentunelionesseaeusuenirqimoutestoitgrandeadesmesure.qnͣtlabiesteuintdeuanteus,elleselessacheoiraspiezdelseinthermitesiꝯmencaaploreramuireagemiraussiꝯmeseelelireqisistaide.limoineenorentgrantpitie.cilplusmeesmementquielleauoitrequisdaide.dontseleualalionessedelaouelegisoitdeuanteussisenalaauantillasuirent.etsiꝯelesenaloitsiarrestoitmoltsouent.regardoitarriereꝑcesauoientilbienqeleuoloitqillasiuissent.queudiroieieplus?tantlesmenalabesteqiluindrentasafosseouelleauoit.v.lionceausnorrisqiiaestoientauquesgranzmesauugleauoientestenez.neencorenauoientilpointdeueueporceenestoitlameretristredolente.dontpristlamereseslionceaussilesaportaiusdelarocesilesmistdeuantlespiezdelseinthermite.lorssotbienliseinzhomqelabesteuoloitdemandoit,sifistsorissonanostresignor.puismistsameinasiolsdeslionceaus.tantostorentilueueqeonqesmaisnauoienteue.lorssedeꝑtirentlimoinedelseinthermiteqilauoientuisite.siraconterentcestmiracleqilauoientueu.mesencoreuconteraiieplusgrantmerueillecarsiꝯmeieoiconterlalionesseuintauchiefde.v.iorzauseinthome:siliaportaunepelmoltbeledenesaiquelbestesilidonaporlegueredonqilliauoitfait.porleseruice.etliseinzhermiteslepristqinedesdeignamieledondelabesteeinzcourisoncorsdelapeldetotesparz.etcestmiracleoiieconterdire.	pluiseurshermiteshabitoientenlermitageqinontmiecelesnehabitaclesouilarrestentonquesetcelsapelentilanacorintes.cilviventderbesetderacinesetsinarrestentonqespormanageenunseulleuporceqeilnevoelentqenulesgenzleshantentmeslaoulanuitlesprentarrestentiltresqalendemeinalajorner.etsontadésenorissonsetenproieres.unenavoitenceldesertdecelemaniereqimoltestoitseinzhomcuiduimoinedelacontreedenitreqimoltestoitdiverseterreetloingassise.vindrentqerreporlesvertuzetporlaseinteeqiloïrentdeluiraconteretdirecarilavoitestémoltlorcompeinsetloramisenlorabeïe.qantilvindrentenlermitage,sileconmencierentaquerremoltlongementtantqa.vii.moisletroverentesdaerrainespartiesdesdeserz.laavoitliseinzhermiteshabité.xii.anzparcespartiesqimoltestoientoriblesetsauvages.etjafustceqilneüstcuredelaconpaigniedenulhomeilnesenfuimieqantilvitcelsqilconoissoiteinzfuensambleoeuspartroisjors.etleurcontapluiseurschoses.auqartjorqantilorentpriscongiéliseinzhomlesconmençaaconvoierparlagrantdesertine.etsicomilaloientensamble,ilvirentunelionesseaeusvenirqimoutestoitgrandeadesmesure.qantlabiestevintdevanteus,elleselessacheoiraspiezdelseinthermitesiconmençaaploreretamuireetagemiraussiconmeseelelireqisistaïde.limoineenorentgrantpitié.etcilplusmeesmementquielleavoitrequisdaïde.dontselevalalionessedelaouelegisoitdevanteussisenalaavantetillasuirent.etsicomelesenaloitsiarrestoitmoltsovent.etregardoitarriereparcesavoientilbienqelevoloitqillasivissent.quevosdiroiejeplus?tantlesmenalabesteqilvindrentasafosseouelleavoit.v.lionceausnorrisqijaestoientauquesgranzmesavugleavoientesténez.neencorenavoientilpointdeveüeetporceenestoitlameretristreetdolente.dontpristlamereseslionceaussilesaportajusdelarocesilesmistdevantlespiezdelseinthermite.lorssotbienliseinzhomqelabestevoloitetdemandoit,sifistsorissonanostresignor.etpuismistsameinasiolsdeslionceaus.ettantostorentilveüeqeonqesmaisnavoienteüe.lorssedepartirentlimoinedelseinthermiteqilavoientvisité.etsiraconterentcestmiracleqilavoientveü.mesencorevosconteraijeplusgrantmerveillecarsiconmejeoïconterlalionessevintauchiefde.v.jorzauseinthome:etsiliaportaunepelmoltbeledenesaiquelbestesilidonaporlegueredonqilliavoitfait.etporleservice.etliseinzhermiteslepristqinedesdeignamieledondelabesteeinzcovrisoncorsdelapeldetotesparz.etcestmiracleoïjeconteretdire.
enceleregionauoitunautrehermiteqiauteleuiemenoitcomcildontieuosaicontedit.sihabitoitenuneautrepartiedeldesert:oupouuenoitnulecreaturehumeine.qnͣtcilseinzhomuintpremiersenlermitageiluiuoitderbes.deracinessiꝯmelacostumeestoitmesilnesauoiteslireneꝯnoistrelesquelesestoientsainesnelesqelesnuisableslegierechosenestmieaconoistreꝑlaforcelasauordesherbesnedesracinescarelesestoientouelmentdocesmesnestoientpasdunemeismenatureeinzeniauoitassezdetelesqemorteluenimportoient.lihermitesqinenconoissoitnulesmengoitaussibienlesunesꝯmelesau--tres.tantqegrantmallempristrent.sienfutormentezdegriesdoleursdedenzsoncorscarparlesmaluesesherbesqilmēgoitnelenpooitnulesdesbonesdemorereluētreilqilnelesrendistꝑvomite.tantsoffriilcestemalaise.qillessatoutlemeng̉tantresoignoitlesdoleursqelesherbeslifaisoientsoffrir.einsiieuna.vii.iorz.tantqepresaloitqilnedefailloitꝑlafamine.dontuintaluiunebeste,sisarrestaensapresencesiesgardaunfaisderbes.qelihermitesauoitcuelliesuniordeuantmesilnesosoitatouchiernemēgierlabestelesꝯmencaasaboucheaeslireadeseurer.tornerdunepartlesmalueses.parcestexampleapristliseīzhomqelesherbesildeuoitmengier.leslsnon.einsinteschapaildelafamine.parlenseignementdelabestecefuassezbeaꝰmiracles.meslongechoseseroitderaconterdedirelesoeuresqeieuienlermitageqiihabitent.qeieioidireautrujquiueulauoitcarieifuiunan.vii.mois.etplusmesmerueilloieiedesmiraclesdesuertuzqeieiueoieqeieiooieconterdire.qeienefeissedeceqeieauoieensihautproposementcomdelaaler:dececomieipooiemenersigriefuie.etmoutsouentdetantcomieifuihabitaiieensambleoleuielhom.qiauoitlepuiᷤlebuef.lecortilasbonesherbescarceestoitmamiudreuiande.	enceleregionavoitunautrehermiteqiauteleviemenoitcomcildontjevosaicontéetdit.etsihabitoitenuneautrepartiedeldesert:oupouvenoitnulecreaturehumeine.qantcilseinzhomvintpremiersenlermitageilvivoitderbes.etderacinessiconmelacostumeestoitmesilnesavoiteslireneconnoistrelesquelesestoientsainesnelesqelesnuisablesetlegierechosenestmieaconoistreparlaforcelasavordesherbesnedesracinescarelesestoientovelmentdocesmesnestoientpasdunemeïsmenatureeinzeniavoitassezdetelesqemortelvenimportoient.lihermitesqinenconoissoitnulesmengoitaussibienlesunesconmelesau--tres.tantqegrantmallempristrent.etsienfutormentezdegriésdoleursdedenzsoncorscarparlesmalvesesherbesqilmengoitnelenpooitnulesdesbonesdemorerelventreilqilnelesrendistparvomite.tantsoffriilcestemalaise.qillessatoutlemengiertantresoignoitlesdoleursqelesherbeslifaisoientsoffrir.einsijeuna.vii.jorz.tantqepresaloitqilnedefailloitparlafamine.dontvintaluiunebeste,sisarrestaensapresencesiesgardaunfaisderbes.qelihermitesavoitcuelliesunjordevantmesilnesosoitatouchiernemengieretlabestelesconmençaasaboucheaeslireetadesevrer.ettornerdunepartlesmalveses.parcestexampleapristliseinzhomqelesherbesildevoitmengier.etlesqelsnon.eteinsinteschapaildelafamine.parlenseignementdelabesteetcefuassezbeausmiracles.meslongechoseseroitderaconteretdedirelesoevresqejevienlermitageetqiihabitent.etqejeioïdireautruiquiveülavoitcarjeifuiunanet.vii.mois.etplusmesmerveilloiejedesmiraclesetdesvertuzqejeiveoieetqejeiooieconteretdire.qejenefeïssedeceqejeavoieensihautproposementcomdelaaler:etdececomjeipooiemenersigriefvie.etmoutsoventdetantcomjeifuihabitaijeensambleolevielhom.qiavoitlepuisetlebuef.etlecortilasbonesherbescarceestoitmamiudreviande.
ce	ce
sont	sont
les	les
ꝑoles	paroles
postumien	postumien
a	a
gaullum	gaullum
a	eta
seuerum	severum
les	les
deciples	deciples
seint	seint
martin	martin
qi	qi
les	les
escoutoient	escoutoient
lafuiie,distpostumiens,a.ii.abeiesqeseinzantoineslihermitesfistencoreisontsideciplehabitent.etsifuielliuouseinzpolslipremiershermiteshabitaensauie:siuiclarogemerqipresestdicelecontreesimonteelmontdesẏnaẏmescenefumietoutensomcarilestsihauzqenushumeinzhomneporroitꝑueniralahautece.laentorhabitoitunshermitesdecelsqiestoientapieleen--acorinthequineuiuoitsederbesnonderacinesqineuoloitauoirꝯpaigniedenulehumeinecreature.celuiquisiemoutlonguementmesonqesnelepoiueoirnetrouerennulemaniere.mesilmefuconteditqilauoitencelhermitagehabite.l.anz.neonqesniauoiteutuesteureeinzestoitsicouerzdepoilquideluiissoitdesescheuels.qilencouroitsanuece.meintreligieushomeslalerentquerreporceqiluoloientaluiparlermestantostcomillesaꝑceuoitsisenfuioitlegrantcoursparlesderrubansdeladesertine.etdedenzcez.l.anzneselessailonsueoirneaparlerdenulhome.forsqaitantsolement:iecroiqecilqialuiꝑlalauoitdeseruiparsauraiefoi.parboinesoeures.etentrepluisorsautresparolesqecilhomparlaaceseinthermite.lidemandailporqoiceestoitqeilseschiuoiteinsidetozhomes.liseinzhermiteslirespondiqecilqiestoithantezdomesauoitlorsolaxlorcompaignie.nepooitmieestrelegierementhantezdesseinzangelesporcestechosedisoientliboenhomedelacontree.qeliangeleuisitoientsouentcelseinthermite	lafuije,distpostumiens,a.ii.abeïesqeseinzantoineslihermitesfistetencoreisontsidecipleethabitent.etsifuielliuouseinzpolslipremiershermiteshabitaensavie:etsiviçlarogemerqipresestdicelecontreeetsimonteelmontdesynaÿmescenefumietoutensomcarilestsihauzqenushumeinzhomneporroitparveniralahautece.laentorhabitoitunshermitesdecelsqiestoientapieléen--acorinthequinevivoitsederbesnonetderacinesetqinevoloitavoirconpaigniedenulehumeinecreature.celuiquisjemoutlonguementmesonqesnelepoiveoirnetroverennulemaniere.mesilmefucontéetditqilavoitencelhermitagehabité.l.anz.neonqesniavoiteütvesteüreeinzestoitsicoverzdepoilquideluiissoitetdeseschevels.qilencovroitsanuece.meintreligieushomeslalerentquerreporceqilvoloientaluiparlermestantostcomillesapercevoitsisenfuioitlegrantcoursparlesderrubansdeladesertine.etdedenzcez.l.anzneselessailonqesveoirneaparlerdenulhome.forsqauntantsolement:etjecroiqecilqialuiparlalavoitdeserviparsavraiefoi.etparboinesoevres.etentrepluisorsautresparolesqecilhomparlaaceseinthermite.lidemandailporqoiceestoitqeilseschivoiteinsidetozhomes.liseinzhermiteslirespondiqecilqiestoithantezdomesetavoitlorsolaxetlorcompaignie.nepooitmieestrelegierementhantezdesseinzangelesetporcestechosedisoientliboenhomedelacontree.qeliangelevisitoientsoventcelseinthermite
quantiemefuideꝑtizdelmontdesẏnaẏiemenrepairaiarrierealariuieredelnil:ouilauoitpluisorsabeiesduneꝑtdautre.iealaipartoutueoirlorleuslorafaires.laenuicieuneouilauoit.c.freressicomieuosaideuantdit.enunautreleu.ii.mile.eltierz.iii.mileqitozuiuoientꝑruile:tenoientobedience.etsinecuidiezmiequentreusqiestoientensambleeustmeinzdeuertuquenpluisorsautresqipartizsestoientdeshumeinesꝯpaigniescarceestoienttuitseinthomeesleu.lorpremeraineuertuzsiestoitobedienceqimoutestgrandenenuzniestoitreceuzdelabeporarresterencompaigniessilnestoitpremierementessaiezbienesprouezqilfustdebonesmeursdeboneuiedontieuosconteraiunmlt̉biaumiracledobedience.quilaestoitnouelementauenuz.	quantjemefuidepartizdelmontdesynaÿjemenrepairaiarrierealarivieredelnil:ouilavoitpluisorsabeïesdunepartetdautre.etjealaipartoutveoirlorleusetlorafaires.laenviçjeuneouilavoit.c.freressicomjevosaidevantdit.etenunautreleu.ii.mile.eteltierz.iii.mileqitozvivoientparruile:ettenoientobedience.etsinecuidiezmiequentreusqiestoientensambleeüstmeinzdevertuquenpluisorsautresqipartizsestoientdeshumeinesconpaigniescarceestoienttuitseinthomeetesleü.etlorpremerainevertuzsiestoitobedienceqimoutestgrandenenuzniestoitreceüzdelabéporarresterencompaigniessilnestoitpremierementessaiezetbienesprovezqilfustdebonesmeursetdeboneviedontjevosconteraiunmoutbiaumiracledobedience.quilaestoitnovelementavenuz.
unshomauoitdeguerpilesseculersconseus.cestsieclepleinem̅tsiestoituenuzaunabequiiaauoituncouentassambledeseinzhomessileꝯmencamoltaangoissierapriierqillereceustensambleoeusenlorconfrarie.liabbesliꝯmencaametremeinteschosesdeuantlidist.qelitrauausdelordreestoitmoltgriezasoffrir:sesꝯmandemenzestoientsidurqemoltlicouendroitauoirgrantpacienceqilesuoudroitacomplirfairemesesleustunautreliuouilseuenquistparpluslegiereordresineꝯmencastmiechoseqilnepeustparfaire.mescilneseuoutonqesmouoirporparoleqeliabbesliseustdireainzdistqilgarderoitsideltoutobedienceqeseliabbesliꝯmandoitaentrerenifeuqilnelerefuseroitmieainzienterroit.qantliabbesloiparlersihardiem̅t,ilsepensaqillesproueroit:sildisoituoirounon.aceleheureeschaufoitlenleforparauenture.siestoitiapleinementesprislifeuzdedenzsiꝯmeporlepeincuire.laꝯmandaliabbesceluiqilientrastsilsesꝯmanzuoloitaemplirfeire.qnͣtciloice,parlagrantfoiparlagrantuolenteqilauoitanostresignor:porceqilneuoloitmietrespasserobedience:neresoignailmielesflambesnelagrantchaleurdesmesureeeinzientradedenzsanzatargement.meintenantperdilagnͣtchaleursaforceaussicomellefistiadizqantlitroienfantfurentmisenlafornaise.etlanaturesormonteequantilmeismesqicuidoitardoir.notnulautremalqeseilfustarrosezdedocerosee.qnͣtliabbesleuit,ilfumoltdolenzporceqilliauoitceꝯmande.liezdautreꝑtie.porlehautmiracle.einsifucilbeneurezprouezparlesꝯmanzqilauoitaemplizdobedience.	unshomavoitdeguerpilesseculersconseus.etcestsieclepleinementsiestoitvenuzaunabéquijaavoituncoventassamblédeseinzhomessileconmençamoltaangoissieretapriierqillereceüstensambleoeusenlorconfrarie.liabbesliconmençaametremeinteschosesdevantetlidist.qelitravausdelordreestoitmoltgriezasoffrir:etsesconmandemenzestoientsidurqemoltlicovendroitavoirgrantpacienceqilesvoudroitacompliretfairemesesleüstunautreliuouilsevenquistparpluslegiereordreetsineconmençastmiechoseqilnepeüstparfaire.mescilnesevoutonqesmovoirporparoleqeliabbesliseüstdireainzdistqilgarderoitsideltoutobedienceqeseliabbesliconmandoitaentrerenunfeuqilnelerefuseroitmieainzienterroit.qantliabbesloïparlersihardiement,ilsepensaqillesproveroit:sildisoitvoirounon.aceleheureeschaufoitlenleforparaventure.etsiestoitjapleinementesprislifeuzdedenzsiconmeporlepeincuire.laconmandaliabbesceluiqilientrastsilsesconmanzvoloitaempliretfeire.qantciloïce,parlagrantfoietparlagrantvolentéqilavoitanostresignor:etporceqilnevoloitmietrespasserobedience:neresoignailmielesflambesnelagrantchaleurdesmesureeeinzientradedenzsanzatargement.etmeintenantperdilagrantchaleursaforceaussicomellefistjadizqantlitroienfantfurentmisenlafornaise.etlanaturesormonteequantilmeïsmesqicuidoitardoir.notnulautremalqeseilfustarrosezdedocerosee.qantliabbeslevit,ilfumoltdolenzporceqilliavoitceconmandé.etliezdautrepartie.porlehautmiracle.einsifucilbeneürezetprovezparlesconmanzqilavoitaemplizdobedience.
enceleabeiemeesmem̅tauintcemiracleqeieuosconteraiia.etadontqantieifui,estoitnouelementauenusicomlenlemecontadistqunsautreshomestrangesuintaceluiabemeismessiliproiamoutdeluirecoiureliabbesdistqillereceueroitsiluoloitaemplirlesꝯmandemenzdobedience.cillidistotencouuentqilneliꝯmanderoitiachoseqilnefeistmoutuolontiers.sanzmalepensee.quilenluiaueroitpacienceuraie.qantceoiliabbes,ilsepensaquillesproueroitparsauoirsilauroitpacience.adonttenoitliabbesuneuergeqilportoitensameingrantpieceauoitqeleestoitsechiee.celeboutaliabbesenterresiꝯmandaaceluiqilaestoituenuzqiltantlarrosastdeaueqeelefustrauerdie.ceestoittoutcontrenaturecarlauergeestoitgnͣttensauoittouteseche.einsintpristcillegriefꝯmandementsiꝯmencalauergeaaroserqilaportoitchascuniorseursesespaulesdelariuieredelnilqiensuzdelaestoitpresde.ii.liues.oresgardezuousqiceescoutezsecenestoitgriefpenanceqecilauoitentreprisafeire:poraemplirlesꝯmandemenzdobedienceeinsiesploitaciltoutlepremereinanqeonqesnecessadeaueaporterdarroserlauergemesonqesnesepotapercoiureqeleenrauerdeistdenoientmeslauertudobedienceduroitparsontrauail.eteinsipassalautrean.onqesnefinadetraueillier.letierzanausint.tresqepriesdelafinadoncꝯmancalauergeꝑlauertudenostresignorarauerdiraflorir.etiemeismes,faitpostumiensaseuerumagaulumsoncompaignōuicdedenzlabeielebuissondeceleuergetoutuertportantfuellessililetlenporceqilportetesmoignagecomgrantchoseestdefoidobedience.etbiensachiezqueancoisseroitliiorztrespasseslanuisuenueqeieuozeusseconteesretreiteslesgranzuertuzqeieaiueuesoiesconter.etporcelesentrelesseraiieseieuozauoieconteduniouēcel:qidelaꝯtreedaiseestoitnez.	enceleabeïemeesmementavintcemiracleqejevosconteraija.etadontqantjeifui,estoitnovelementavenusicomlenlemecontaetdistqunsautreshomestrangesvintaceluiabémeïsmessiliproiamoutdeluireçoivreetliabbesdistqillereceveroitsilvoloitaemplirlesconmandemenzdobedience.cillidistetotencouventqilneliconmanderoitjachoseqilnefeïstmoutvolontiers.etsanzmalepensee.etquilenluiaveroitpaciencevraie.qantceoïliabbes,ilsepensaquillesproveroitparsavoirsilauroitpacience.adonttenoitliabbesunevergeqilportoitensameinetgrantpieceavoitqeleestoitsechiee.celeboutaliabbesenterresiconmandaaceluiqilaestoitvenuzqiltantlarrosastdeaueqeelefustraverdie.etceestoittoutcontrenaturecarlavergeestoitgranttensavoittouteseche.einsintpristcillegriefconmandementsiconmençalavergeaaroserqilaportoitchascunjorseursesespaulesdelarivieredelnilqiensuzdelaestoitpresde.ii.liues.oresgardezvousqiceescoutezsecenestoitgriefpenanceqecilavoitentreprisafeire:poraemplirlesconmandemenzdobedienceeinsiesploitaciltoutlepremereinanqeonqesnecessadeaueaporteretdarroserlavergemesonqesnesepotaperçoivreqeleenraverdeïstdenoientmeslavertudobedienceduroitparsontravail.eteinsipassalautrean.qeonqesnefinadetraveillier.etletierzanausint.tresqepriesdelafinetadoncconmançalavergeparlavertudenostresignoraraverdiretaflorir.etjemeïsmes,faitpostumiensaseverumetagaulumsoncompaignonviçdedenzlabeïelebuissondecelevergetoutvertetportantfuellesetsililetlenporceqilportetesmoignagecomgrantchoseestdefoietdobedience.etbiensachiezqueançoisseroitlijorztrespassésetlanuisvenueqejevozeüsseconteesetretreiteslesgranzvertuzqejeaiveüesetoïesconter.etporcelesentrelesseraijesejevozavoiecontédunjovencel:qidelacontreedaiseestoitnez.
ciliouenceaus,sicomieuosdi,estoitnezdelacontreedaise:moutrichessiauoitunfildesafemeqeuosdiroieieloncconteiluintenegẏpte.uitpluiseurstabernaclesdeseinzhomesmoltliplotceleuieamenercarunsseinzhermites,iehansauoitnonlauoitmoutensigniedoctrinedelaꝑoledesalu.queuosdiroieieplus?nedemoramielonctensqilentraenlermitagepormenerseinteuiesolitaireenpetitdetensseprouailsibelementparieunes,parhumilite,parfermefoiqilfuinguausdeuertuapluiseursancienshomes.qimeneiauoientboneuiepuremeslideableslimistunepenseeaucuerauchiefde.iiii.anzqilotceleboneuiemenee:qeplusdroiturierechoseseroitplusacceptableadeuqilsenralastensonpaisasafeme.asōfilasamesnieqeceqilsefustsimisdeltouthorsdelsiecle.lessastcelsqildeuoitgarder.poruiureadoleurapaine.parcestefolepenseelessailsacelle.lermitageouilauoitpremiersproposeaestͤtozlesiorzdesauie.mesqantiluintalabeieplusproceine.ouilauoitpremiersaussiesteilcontaasesfrereslochoisonporqoiilissoitdelermitage.ettuitliꝯmencierentmoltdurementablasmerliabbesdeuanttozlesautresmeslamalepenseeqiliestoitentreeelcuernenpooitpartirporchoseqelenlideistcartoteseuressedeꝑtiildesesfreres:qimlt̉grantdoelendemenerent.mesilnotmiemoutloingaleensusdelabeieqnͣtlideableslientraelcorsqilecomencasiatormenter:qeilpristluimeismesadespechierasesdenzagieterescumeparlabouche.lorslepristrentlifrere,silereporterentarrieresililierentlesmeinzlespiezsicomilliestoitbesoinz.aprescegranttensqilotesteeinsigarde,fuildelivresdelanemi:parlesorissonsdesseinzhomes.etqantilfugueriz,sirepairaisnelementenlermitagesifuchastiiesꝑcestechosesidonaasautresexamplesqiapresluiestoientauenirqilnefussentmiesisousprisparlauanitedelorfollespenseesquilendeguerpissentlesbonesoeuresqilauoientꝯmencieafaire.	ciljovenceaus,sicomjevosdi,estoitnezdelacontreedaise:moutrichessiavoitunfildesafemeqevosdiroiejeloncconteilvintenegypte.etvitpluiseurstabernaclesdeseinzhomesetmoltliplotcelevieamenercarunsseinzhermites,jehansavoitnonlavoitmoutensigniéetdoctrinédelaparoledesalu.quevosdiroiejeplus?nedemoramielonctensqilentraenlermitagepormenerseintevieetsolitaireetenpetitdetensseprovailsibelementparjeunes,parhumilité,parfermefoiqilfuinguausdevertuapluiseursancienshomes.qimenéiavoientbonevieetpuremeslideableslimistunepenseeaucuerauchiefde.iiii.anzqilotceleboneviemenee:qeplusdroiturierechoseseroitetplusacceptableadeuqilsenralastensonpaïsasafeme.etasonfiletasamesnieqeceqilsefustsimisdeltouthorsdelsiecle.etlessastcelsqildevoitgarder.porvivreadoleuretapaine.parcestefolepenseelessailsacelle.etlermitageouilavoitpremiersproposéaestretozlesjorzdesavie.mesqantilvintalabeïeplusproceine.etouilavoitpremiersaussiestéilcontaasesfrereslochoisonporqoiilissoitdelermitage.ettuitliconmencierentmoltdurementablasmeretliabbesdevanttozlesautresmeslamalepenseeqiliestoitentreeelcuernenpooitpartirporchoseqelenlideïstcartoteseuressedepartiildesesfreres:qimoutgrantdoelendemenerent.mesilnotmiemoutloingaléensusdelabeïeqantlideableslientraelcorsqilecomençasiatormenter:qeilpristluimeïsmesadespechierasesdenzetagieterescumeparlabouche.lorslepristrentlifrere,silereporterentarrieresililierentlesmeinzetlespiezsicomilliestoitbesoinz.apréscegranttensqilotestéeinsigardé,fuildelivrésdelanemi:parlesorissonsdesseinzhomes.etqantilfugueriz,sirepairaisnelementenlermitageetsifuchastiiésparcestechosesidonaasautresexamplesqiaprésluiestoientavenirqilnefussentmiesisousprisparlavanitédelorfollespenseesquilendeguerpissentlesbonesoevresqilavoientconmenciéafaire.
oruousaiieceschosesconteesditesdemiraclesdeuertuz:qenostresiresfaitporsesserzenegẏpteceuosensousfisse.maisporceqeieuosaiconteceqiluosplotaoir:ouplus,cequic,qeieneuosdeussedireieteproi,seuere,qetumeracontesdetonmartin.qiarceuesqesfudetors.aucunechosecariedesirremoutsesfaisaoiraentendre.	orvousaijeceschosesconteesetditesdemiraclesetdevertuz:qenostresiresfaitporsesserzenegyptecevosensousfisse.maisporceqejevosaicontéceqilvosplotaoïr:ouplus,cequiç,qejenevosdeüssedirejeteproi,severe,qetumeracontesdetonmartin.qiarcevesqesfudetors.aucunechosecarjedesirremoutsesfaisaoïretaentendre.
seuerus	severus
li	li
respondi	respondi
qetenporroieiedire:dontnetesosfistliliuresqetusezqeiefisdesuertuzdesmiraclesqilfistdesauie	etqetenporroiejedire:dontnetesosfistlilivresqetusezqejefisdesvertuzetdesmiraclesqilfistetdesavie
postumiens	postumiens
respondi	respondi
liliuresenqoisauieestoitescriteqetufeis:nesedeꝑtipiecademoi:setulereconoissoies,ieletemosterroie.	lilivresenqoisavieestoitescriteqetufeïs:nesedepartipieçademoi:etsetulereconoissoies,jeletemosterroie.
lors	lors
traist	traist
leliure	lelivre
desoz	desoz
sa	sa
uesteure	vesteüre
si	si
louri	lovri
si	si
dist	dist
a	a
seuerum	severum
a	eta
gaulum	gaulum
ueezicitoutesauieescrite.cisliuresaestemescompeinzmesconfors:parterreꝑmerpartoutmonpelerinage.ieteracōtereitotpleinementouilaesteportezsinestnusleusentoutcestsieclequelamateredesibeneureuseestoirenesoitconteedite.	veezicitoutesavieescrite.etcislivresaestémescompeinzetmesconfors:parterreetparmeretpartoutmonpelerinage.etjeteracontereitotpleinementouilaestéportezetsinestnusleusentoutcestsieclequelamateredesibeneüreuseestoirenesoitconteeetdite.
aupremierlemportadetoiaromepauliusunsseinzhom:dontfuilrauizꝑtotelacite.etcilqileliureuendoientlamoiētmlt̉carilnenuendoientnulautretantcier.etqantieoilamertrespassee.ieuingenaufriqesitrouaiieqelenlelissoitpartotechartage:tuitlauoientforsunsseusprestres:qiauoitnoncẏrenensesmesillescristparmoicarielenprestailexemplaire.etqediroieiedalexandrelaconoistlenaussibienseitcontumeismeslesesqilefeisetenegẏpte.enlaterredenitre.enlacontreedethebespartoutleregnedinde.meesmementelparfonthermitagetrouaiieunuielhomeqilelissoitaceluidisieqeiestoiemouttesamistesfamuliers.etilmeproiapluiseursautresfreresseiereuenoieiaencesteterreietetrouoiehaitieqeieteproiassetantqetuacompleissesleliureqetuasfetdesuertuzauseinthomeqetuastrespassees.ormedidonqessacesbienqeieneuoelmieoirleschosesqisontescritesmescelesquetuastrespasseesporceqelesnanuiassentaceusqilesleussent.	aupremierlemportadetoiaromepauliusunsseinzhom:etdontfuilravizpartotelacité.etcilqilelivrevendoientlamoientmoutcarilnenvendoientnulautretantcier.etqantjeoilamertrespassee.etjevingenaufriqesitrovaijeqelenlelissoitpartotechartage:ettuitlavoientforsunsseusprestres:qiavoitnoncyrenensesmesillescristparmoicarjelenprestailexemplaire.etqediroiejedalexandrelaconoistlenaussibienetseitcontumeïsmeslesesqilefeïsetenegypte.etenlaterredenitre.etenlacontreedethebesetpartoutleregnedinde.etmeesmementelparfonthermitagetrovaijeunvielhomeqilelissoitetaceluidisjeqejestoiemouttesamisettesfamuliers.etilmeproiaetpluiseursautresfreressejerevenoiejaencesteterreetjetetrovoiehaitiéqejeteproiassetantqetuacompleïsseslelivreqetuasfetdesvertuzauseinthomeqetuastrespassees.ormedidonqesetsacesbienqejenevoelmieoïrleschosesqisontescritesmescelesquetuastrespasseesporceqelesnanuiassentaceusqilesleüssent.
dont	dont
respondi	respondi
seuerus	severus
a	a
postumien	postumien
sidist	etsidist
postumien,laouietoiraconterdirelesuertuzdesseinzhomes.qetunosasditessipensoieieqetotesleschosesqechascunsafaiteseustfaitmartins,liarceuesqesdetors,moltlegierement.etencorenosaiestuhauteschosesconteesditesienainulerienoidetoisauuelapaisdesseinzhomesdonttuasparlequilnaitfaitplusgrandes.meseinsicomilmesamblecomieregehis.qelennedoitlesuertuznelesmiraclesdesaintmartin.nesesmeritesmetreanulhomeqioressoitenuieeinsimesambleilqecesoitfelonie:qelenledenulerienalaconditiondehermitenedenacorintecarlihermitesontforsdetozlesempeechemenzdecestsieclesinepensenttantsolementforsasoeuresdelcielsinefontrienssecenonqeliangelelorenseignentmescilfuenmilacompaigniedelsiecle.entrelaconuersationdelpueple.entrelesclersqisouentlegaitoient.entreleseuesqesqiforsenoientdeluiauoientenuie.chascuniorauoitpainesescandres.etparmitoutcefuilfondesdesigranzuertuz.qilfistauteusmiraclesougrignorscomnosoimesonqesconter,qehermitesfeissent.qideuantluifussentnenesoientencoreenlermitage.qelesuicesseroitceqisimaldroituriersseroitqinediroit.qeseinzmartinsfustpluspuissanzpardroit:qenusdeceusdonttunosascontesacesbienqilfucheualiers,qilsecombatielfelonleu:eschapaensambleolauictoiremescilsontcheualieriuwelqisontenlermitagecarilfontiuelmentꝑeusseuslorbatailles.orlessonsestertoutesceschosessaeusaluiauoitesteunemeesmeuictoireiuelmentniseroitmieiuelgloireetencorenosaiestuditesraconteesmeintesbelesmiraclestunenosasmieraconteqenusdeusresuscitastonsnulhomedemortauie.etporcetediiequelennedoitnulmetreneconfermeraseintmartin.etsetutesmerueillesdeceqelesflambesnefirentmalalegẏptienqiiutenlafornesesacesqelesflambesnelifeunosoienttrespasserlecomandementdecestuyetsetudisqelacruiautesdesbestessaluagesestoitapaisieporlanacorintedonttumascontesacesaussiqecilcuroitguerissoitdetozlesueninsdesserpenz:apaisoitaussintlesragesdesbestessauuages:curoitsanoitparsaparoleceusqiestoiententreprisdeldeableuoiremeesmementꝑlafrangedesauesteureetsetuparolesdeceluiquidesescheueusestoitcouerz:nenauoitautreuesteureporcecuidoitlenqilfustuisitezdesangelessacesbienqeliangeleꝑloientacestuicascunior.etporceestilreisons.tureiehisses:qetotescezuertuzqilfirentqetuasracontees:furentenseintmartin:ilnefurentmiepuissanzdetotescelesfaireqeseinzmartinsfist.	postumien,laoujetoïraconteretdirelesvertuzdesseinzhomes.qetunosasditessipensoiejeqetotesleschosesqechascunsafaiteseüstfaitmartins,liarcevesqesdetors,moltlegierement.etencorenosaiestuhauteschosesconteesetditesjenainulerienoïdetoisauvelapaisdesseinzhomesdonttuasparléquilnaitfaitplusgrandes.meseinsicomilmesambleetcomjeregehis.qelennedoitlesvertuznelesmiraclesdesaintmartin.nesesmeritesmetreanulhomeqioressoitenvieeinsimesambleilqecesoitfelonie:qelenledenulerienalaconditiondehermitenedenacorintecarlihermitesontforsdetozlesempeechemenzdecestsiecleetsinepensenttantsolementforsasoevresdelcieletsinefontrienssecenonqeliangelelorenseignentmescilfuenmilacompaigniedelsiecle.etentrelaconversationdelpueple.etentrelesclersqisoventlegaitoient.etentrelesevesqesqiforsenoientetdeluiavoientenvie.etchascunjoravoitpainesetescandres.etparmitoutcefuilfondésdesigranzvertuz.qilfistauteusmiraclesougrignorscomnosoïmesonqesconter,qehermitesfeïssent.qidevantluifussentnenesoientencoreenlermitage.qelesvicesseroitceqisimaldroituriersseroitqinediroit.qeseinzmartinsfustpluspuissanzpardroit:qenusdeceusdonttunosascontésacesbienqilfuchevaliers,qilsecombatielfelonleu:eteschapaensambleolavictoiremescilsontchevalierjuwelqisontenlermitagecarilfontivelmentpareusseuslorbatailles.orlessonsestertoutesceschosessaeusetaluiavoitestéunemeesmevictoireivelmentniseroitmieivelgloireetencorenosaiestuditesetraconteesmeintesbelesmiraclestunenosasmieracontéqenusdeusresuscitastonqesnulhomedemortavie.etporcetedijequelennedoitnulmetreneconfermeraseintmartin.etsetutesmerveillesdeceqelesflambesnefirentmalalegyptienqijutenlafornesesacesqelesflambesnelifeunosoienttrespasserlecomandementdecestuyetsetudisqelacruiautésdesbestessalvagesestoitapaisieporlanacorintedonttumascontésacesaussiqecilcuroitetguerissoitdetozlesveninsdesserpenz:etapaisoitaussintlesragesdesbestessauvages:etcuroitetsanoitparsaparoleceusqiestoiententreprisdeldeablevoiremeesmementparlafrangedesavesteüreetsetuparolesdeceluiquidesescheveusestoitcoverz:nenavoitautrevesteüreetporcecuidoitlenqilfustvisitezdesangelessacesbienqeliangeleparloientacestuicascunjor.etporceestilreisons.qeturejehisses:qetotescezvertuzqilfirentetqetuasracontees:furentenseintmartin:etilnefurentmiepuissanzdetotescelesfaireqeseinzmartinsfist.
postumiens	postumiens
respondi	respondi
dist	etdist
tuꝑolesausintamoicomeseieneseusseqetumecontes.sifaz,ielesaibienmestoztensloeraiielesmoinesdegypte:lesanacorintes.leshermitesetdeuanttozcelsloeraiieseintmartin:neienoseroiemiealuicomparereuesqesnemoinesqeieconoissecetesmoigneegẏptetoutesẏre.totelacontreedeethẏopeindeꝑtotelaterredestursenestialanouielealee.lesetlenpartotehermenie.parbosfore:qiestdaerreinedesꝑtiesdindeetsileseuentconoissenttuitcilqihabitētesdaerreinespartiesdocceanceestlagnͣtmerqitotlemontauirone.etencestleuouilhabitaleconoistlenmeinsqentotesautresregionsprestre.clerc.roi.conteprince.lipueplesneleuoelentconoistrecarsilleꝯneussentcreussentsesgranzuer--tussesgransmiraclesildeguerpeissētloruiceslormalesoeures.encoreaiiegranthontederamentoiureceqeieoilautreioraunmaleureusdirecarildistqeelliureqetufeisauoiestumentidepluiseurschosesetiesaibienqeceqeielioidire:nefumieuoizdomeainzfuuoizdedeableneparcenenabessaseinzmartinsdenoientmesilfuparsaparoleenꝯtrelafoidelaseinteeuuangilecarnostresiresmeismesdistqelesoeuresqeseinzmartinsacomplifistdenoientaꝯplir.feiretuitcilqifeelestoient.meslimaleureusqiennostresignornecroientneenluifiancenauoient.auoienthonteontencore.desmiraclesqenostresiresfaitfaisoitporlesseinzhomesporceqilnenuoltnulesporeusfeiremesporceqenosuolonsdautrechosetraitierparlerlessonsdeceuslememorielaparole.simeraconteauantlesoeuresdeseintmartinqeieaimoltdesirre.	tuparolesausintamoicomesejeneseüsseqetumecontes.sifaz,jelesaibienmestoztensloeraijelesmoinesdegypte:etlesanacorintes.etleshermitesetdevanttozcelsloeraijeseintmartin:nejenoseroiemiealuicomparerevesqesnemoinesqejeconoissecetesmoigneegypteettoutesyre.ettotelacontreedeethyopeetindeetpartotelaterredestursenestjalanovielealee.etlesetlenpartotehermenie.etparbosfore:qiestdaerreinedespartiesdindeetsileseventetconoissenttuitcilqihabitentesdaerreinespartiesdocceanceestlagrantmerqitotlemontavirone.etencestleuouilhabitaleconoistlenmeinsqentotesautresregionsprestre.etclerc.etroi.etconteetprince.etlipueplesnelevoelentconoistrecarsilleconneüssentetcreüssentsesgranzver--tusetsesgransmiraclesildeguerpeïssentlorvicesetlormalesoevres.encoreaijegranthontederamentoivreceqejeoïlautrejoraunmaleüreusdirecarildistqeellivreqetufeïsavoiestumentidepluiseurschosesetjesaibienqeceqejelioïdire:nefumievoizdomeainzfuvoizdedeableneparcenenabessaseinzmartinsdenoientmesilfuparsaparoleencontrelafoidelaseinteeuvangilecarnostresiresmeïsmesdistqelesoevresqeseinzmartinsacomplietfistdenoientaconplir.etfeiretuitcilqifeelestoient.meslimaleüreusqiennostresignornecroientneenluifiancenavoient.avoienthonteetontencore.desmiraclesqenostresiresfaitetfaisoitporlesseinzhomesporceqilnenvoltnulesporeusfeiremesporceqenosvolonsdautrechosetraitieretparlerlessonsdeceuslememorieetlaparole.etsimeraconteavantlesoevresdeseintmartinqejeaimoltdesirré.
se	se
uerus	verus
respondi	respondi
a	a
postumien	postumien
si	etsi
dist	dist
tudeueroiesmielzdemander,sicomiecuic,soloncdroiture.ceqetumerueuesconterdireaceluiqitoutadesfusesdeciplescarlideciplesseitmiuslesoeuresdesonmestͤqenusautresceestgallusqiensambleoluifu:tressenfance.porceqeieaileliurefait.qiiaestracontesleusparpluiseursterressicomtumeismesmeracōtesporceestildroisqilauantnosracontelestoirecarsicomeieaiditdeuant,illedoitfeiresinelidoitmiegreuerneanuierderaconter:lesfeisdeseintmartinnelesexamples.	tudeveroiesmielzdemander,sicomjecuiç,soloncdroiture.ceqetumeruevesconteretdireaceluiqitoutadésfusesdeciplescarlideciplesseitmiuslesoevresdesonmestreqenusautresetceestgallusqiensambleoluifu:tressenfance.etporceqejeailelivrefait.qijaestracontésetleüsparpluiseursterressicomtumeïsmesmeracontesporceestildroisqilavantnosracontelestoirecarsicomejeaiditdevant,illedoitfeireetsinelidoitmiegreverneanuierderaconter:lesfeisdeseintmartinnelesexamples.
lors	lors
respondi	respondi
gaulus	gaulus
si	etsi
dist	dist
encorenesoieiemiesidignesderacontersigrantoeureliexampledobedienceqepostumiensnosracontemeconstreintaceqeienerefusiemieceqeuosmesrouezproiesqeiediemesiemecriemmoltqemesparolesnesoientmiesibienassises.comlespluisorsqeuosauezoiesmesnonporqant.ieuosconteraiceqeieenauraiueu.alaplusbelemaniereqeieporaisaurai.	encorenesoiejemiesidignesderacontersigrantoevreliexampledobedienceqepostumiensnosracontemeconstreintaceqejenerefusiemieceqevosmesrovezetproiésqejediemesjemecriemmoltqemesparolesnesoientmiesibienassises.comlespluisorsqevosavezoïesmesnonporqant.jevosconteraiceqejeenauraiveü.alaplusbelemaniereqejeporaietsaurai.
dont	dont
dist	dist
postumiens	postumiens
galle,di.paroleseurementcariereiehiscroiqe,setuestoiesmussanzparole.tudeseintmartinparleruoloiessesfezraconter,qetutaparoleraueroiesaussintꝯmezacharielerotpordemonstrerlenonseintiehanbaptiste.mesorꝯmenceheitiementsinosraconteceqetuensezueiscarnosauonsausdetensgasteenautresparoles.lanuizaprocheqinossemontqetudeconternetargesmie.	galle,di.etparoleseürementcarjerejehisetcroiqe,setuestoiesmusetsanzparole.ettudeseintmartinparlervoloiesetsesfezraconter,qetutaparoleraveroiesaussintconmezacharielerotpordemonstrerlenonseintjehanbaptiste.mesorconmenceheitiementetsinosraconteceqetuensezetveïscarnosavonsauqesdetensgastéenautresparoles.etlanuizaprocheqinossemontqetudeconternetargesmie.
adonc	adonc
ꝯmenca	conmença
gallus	gallus
en	en
tel	tel
maniere	maniere
aparler	aparler
si	etsi
dist	dist
ilmecouientelꝯmencementgarderqeienerecontemieceqeseuerusenacōteditensonliure.simecouienttrespasserceqilfist.qantilfucheualiersausiecleqantilfumoines.etceqeliautreenuontcontantqilontasautresoiconterdireeinzuosdiraiceqeieenaiueuamesiolstantcomiefuiensambleoluiensacompaignie.aprescepetitdeiorzqeieoideguerpilesiecle.qeiefuiuenuzensacompaignieilauintqilaloitaumost̉.iepluiseurautreclercoluiensamble.enlauoieuintunspoureshomaluiquiauoitmoutpeudedrassifesoitmoutfroitsicomeltensdẏuersiliproiamoltdoucementpordeuqildonastaucuneuesteure.liseinzhomotpitiedelpourehomesiapelasonarchediacre:qideseschosesestoitprocureressiliproiacoumandaqiluestistcelpourehomesanzatargier.apresceentraelmostier,sialaseoirelsecretairetozseussicomilauoitausacostumecariatantliprestreneliclercneparlassentelmostierdelorbesoignesneneseissentporlorafaires.qeliseinzhomsenmellast.qilfustailleursquenliusolitairebiensachiezquenleglisseneliuitonqesnusseoirneenzelliusecretaireouilseoitseuzneseoitilmieseurchaeremesseuruneseletea.iii.piez.mesieuosdiiureꝑdeu:sienaiiegranthontedeceqeieleconte:qeieleuiseoirenleglisseenhautaussicomesorunroialsiegesinestoitnefezneatornezꝑoeurehumeine.mesceuenuoelielessiersiuosdiraidelpourehomeqitantfistqiluintenselsecretairelaouliseinzeuesqesestoitenorissons.silidistqeliclersquiilauoitꝯmandeneliauoitpasdonesauesteure.quantliseinzhomloiilostasacotedesozsauesteure:sicoiementqelipoureshomneleuitmiepuislidona:seliꝯmandaqilsedeꝑtisistdiluecisnelement.apresceunpetitreuintliarcediacresauseīteuesqe.silidistqelipuepleslatendoitporchantersicomilestoitacostume.ilrespondisidistqilcouendroitpmierslepoureuestir.qilneporroitaleraleglisse,selipouresnauoituesteuretoutcedisoitildeluimeismes.liarchediacresqinentendoitmiealaparole:distalafin.qilnauoitonqespuisueulepoure.liseinzhomlidistqilliaportastlauesteureqilauoitaparellie.lipouresnenremanroitmielongemētauestir.dontfuliclersconstreinzdelaparole.parbesoingparicesencoruterranment.alatauerneqiplusestoitdelmostierproceinesiachetaunenoireuesteuredurecorte.v.denierssilaportadeuantseintmartinsilimisttoziriesasespiezsilidistveezicilauesteuremeslipouresniestmie.lorslapristliseinzhomsanzcorrociersidistalarcediacreqiaporteelauoitqilalastforsdelasecretaireunpetitcedisoitil,porceqiluoloitcoiementuestirceleuesteure.elleudeceleqilauoitdoneeaupouresicomilfistcarilestoitdesnuezdesozsaffubleuresisepenoitmlt̉qelennepeustaꝑceuoircesteoeureqilauoitfete.mesꝯmentpeustestreceleecestechoseqeliseinzhomauoitfaiteꝑgrantmisericordecenepuetestreqelesoeuresdesseinzsoientsireuseesqelennessacecariluoellentounon,lorꝯuientdireaceusqilordemandent.sicomliseinzhomalaalautel.porchanterlamessetozreuestuzdeseureceleuesteureilotbeneilautelnosueimesuneflambeissirdesonchiefqisestendoitenhaut:ceestoitunechosedontnosmoltnosesmerueillions.ceuirentpluiseurdoupueplenonmiegrantpartieunedesuirgesqienleglisseestoitunsprestres.iiii.moinetantsolementneplusdegenzneleuirent.etsineuossaidirelochoisonporqoitozneleporentueoirnelaraissoncarnosnesauonsmieiuchierdesoeuresnostresignor.etcefuhauteoeurebelmiracle.	ilmecovientelconmencementgarderqejenerecontemieceqeseverusenacontéetditensonlivre.etsimecovienttrespasserceqilfist.qantilfuchevaliersausiecleetqantilfumoines.etceqeliautreenvontcontantqilontasautresoïconteretdireeinzvosdiraiceqejeenaiveüamesiolstantcomjefuiensambleoluietensacompaignie.apréscepetitdejorzqejeoideguerpilesiecle.etqejefuivenuzensacompaignieilavintqilaloitaumostier.etjeetpluiseurautreclercoluiensamble.enlavoievintunspovreshomaluiquiavoitmoutpeudedrasetsifesoitmoutfroitsicomeltensdyversiliproiamoltdoucementpordeuqildonastaucunevesteüre.liseinzhomotpitiédelpovrehomesiapelasonarchediacre:qideseschosesestoitprocureressiliproiaetcoumandaqilvestistcelpovrehomesanzatargier.aprésceentraelmostier,sialaseoirelsecretairetozseussicomilavoitausetacostumecarjatantliprestreneliclercneparlassentelmostierdelorbesoignesneneseïssentporlorafaires.qeliseinzhomsenmellast.etqilfustailleursquenliusolitaireetbiensachiezquenleglissenelivitonqesnusseoirneenzelliusecretaireouilseoitseuzneseoitilmieseurchaeremesseuruneseletea.iii.piez.mesjevosdietjurepardeu:etsienaijegranthontedeceqejeleconte:qejeleviseoirenleglisseenhautaussicomesorunroialsiegeetsinestoitnefezneatornezparoevrehumeine.mescevosenvoeljelessiersivosdiraidelpovrehomeqitantfistqilvintenselsecretairelaouliseinzevesqesestoitenorissons.etsilidistqeliclersquiilavoitconmandéneliavoitpasdonésavesteüre.quantliseinzhomloïilostasacotedesozsavesteüre:sicoiementqelipovreshomnelevitmieetpuislidona:etseliconmandaqilsedepartisistdiluecisnelement.aprésceunpetitrevintliarcediacresauseintevesqe.etsilidistqelipuepleslatendoitporchantersicomilestoitacostumé.ilrespondietsidistqilcovendroitpremierslepovrevestir.etqilneporroitaleraleglisse,selipovresnavoitvesteüretoutcedisoitildeluimeïsmes.liarchediacresqinentendoitmiealaparole:distalafin.qilnavoitonqespuisveülepovre.liseinzhomlidistqilliaportastlavesteüreqilavoitaparellie.etlipovresnenremanroitmielongementavestir.dontfuliclersconstreinzdelaparole.etparbesoingetparicesencoruterranment.alataverneqiplusestoitdelmostierproceinesiachetaunenoirevesteüredureetcorte.v.denierssilaportadevantseintmartinsilimisttoziriésasespiezsilidistveezicilavesteüremeslipovresniestmie.lorslapristliseinzhomsanzcorrociersidistalarcediacreqiaporteelavoitqilalastforsdelasecretaireunpetitetcedisoitil,porceqilvoloitcoiementvestircelevesteüre.elleudeceleqilavoitdoneeaupovresicomilfistcarilestoitdesnuezdesozsaffubleüreetsisepenoitmoutqelennepeüstapercevoircesteoevreqilavoitfete.mesconmentpeüstestreceleecestechoseqeliseinzhomavoitfaitepargrantmisericordecenepuetestreqelesoevresdesseinzsoientsireuseesqelennessacecarilvoellentounon,lorconvientdireaceusqilordemandent.sicomliseinzhomalaalautel.porchanterlamessetozrevestuzdeseurecelevesteüreetilotbeneïlautelnosveïmesuneflambeissirdesonchiefqisestendoitenhaut:etceestoitunechosedontnosmoltnosesmerveillions.cevirentpluiseurdoupuepleetnonmiegrantpartieetunedesvirgesqienleglisseestoitetunsprestreset.iiii.moinetantsolementneplusdegenznelevirent.etsinevossaidirelochoisonporqoitozneleporentveoirnelaraissoncarnosnesavonsmiejuchierdesoevresnostresignor.etcefuhauteoevreetbelmiracle.
enceltensmeismesauoieieunoncleqieuanchiusestoitapelezcrestiensbaptiziezestoitmesausieclesetenoitsiestoitensigniezdesaferesdecestmondesiꝯmemeintautrepreudomesont.celuipristunesigranzenfertezsiorible.qetuitcilqileueoiētcuidoientqildeusttrespasserdecestsiecle.sicomilestoitentelpointilmandaseītmartinqiluenistalui.liseinzhomialaerranmentmesancoisqilparuenistenmiuoiesentilimaladeslauertudelseinthome.recutsantemeintenantenleuresigrantqiluintencontrenosqialuiuenions.qantuintalendemeinliseinzarcheuesqessenuoutaler.lipreudomliproiamoutdocementqilpardemorasttoutceiorettantlidistqildemoraalaparfinparsaproiere.	enceltensmeïsmesavoiejeunoncleqievanchiusestoitapelezetcrestiensbaptiziezestoitmesausieclesetenoitsiestoitensigniezdesaferesdecestmondesiconmemeintautrepreudomesont.celuipristunesigranzenfertezetsiorible.qetuitcilqileveoientcuidoientqildeüsttrespasserdecestsiecle.sicomilestoitentelpointilmandaseintmartinqilvenistalui.liseinzhomialaerranmentmesançoisqilparvenistenmivoiesentilimaladeslavertudelseinthome.etreçutsantémeintenantenleuresigrantqilvintencontrenosqialuivenions.qantvintalendemeinliseinzarchevesqessenvoutaler.lipreudomliproiamoutdocementqilpardemorasttoutcejorettantlidistqildemoraalaparfinparsaproiere.
encelmeismeiorauintqunsserpenzpoinstunseriantdelamesonsilenuenimademorteluenim.lenleuintanoncierausigneurdelamesonsilidistlenqeunsserpenzauoitenuenimeundesesserianzsitraioitiaafin.neniauoitnusesperancedeuie.qanteuanchiuslentendiilmeismesicorutsilepristasoncol,silemportaaspiezseintmartin.liueninsestoitiaespanduzꝑtozlesmembressiqeuosueissiezlecuirtoutenfleuentregrosestendu.lorsmistliseinzhomsesmeinsꝑtozlesmembresdeceluitantqesondoituintiostelaplaieparouliserpenzlauoitenuenime.jeuosdiraiiamerueillescarnosueimesqienuironestions.qeliuenīsqiestoitespanduzꝑtozlesmembres.reuintaudoitseintmartin:parlaplaierissifors.sancensambleasigrantfoison.entelemaniereꝯmeilleustespresse:toutaussicomlilezistdelamamelealabrebisqantlenlatret.dontseleuaciltozhaitiez.futozguerizdeluenimdelenfleure.nosfumestuitesbahi.porlegrantmiraclesidisionsentrenosceqeueritezestoit:qilnestoitnusdesozlecielqipeustseintmartinensiuredefeznedueures.	encelmeïsmejoravintqunsserpenzpoinstunserjantdelamesonsilenvenimademortelvenim.lenlevintanoncierausigneurdelamesonsilidistlenqeunsserpenzavoitenveniméundesesserjanzsitraioitjaafin.neniavoitnusesperancedevie.qantevanchiuslentendiilmeïsmesicorutsilepristasoncol,silemportaaspiezseintmartin.etliveninsestoitjaespanduzpartozlesmembressiqevosveïssiezlecuirtoutenfléetventregrosetestendu.lorsmistliseinzhomsesmeinspartozlesmembresdeceluitantqesondoitvintjostelaplaieparouliserpenzlavoitenvenimé.jevosdiraijamerveillescarnosveïmesqienvironestions.qeliveninsqiestoitespanduzpartozlesmembres.revintaudoitseintmartin:etparlaplaierissifors.etsancensambleasigrantfoison.etentelemaniereconmeilleüstespressé:ettoutaussicomlilezistdelamamelealabrebisqantlenlatret.dontselevaciltozhaitiez.etfutozguerizdelvenimetdelenfleüre.etnosfumestuitesbahi.porlegrantmiraclesidisionsentrenosceqeveritezestoit:qilnestoitnusdesozlecielqipeüstseintmartinensivredefezneduevres.
aprescenotmielonctens.senalaseinzmartinsnosensambleolui.auneuileenseueschieporuisiterceusqicrestienestoient.pormostrerlaparolenostresignorsicomillauoitacostume.sicomnosalamestotelauoieensamblenosdemoramesarriere,nesaiporquelchoseilsenaladeuātnostozmoutgrantpiece.qantilnosotmouteslongiesilgarda,siuituenirunegranttorbedegent:qiuersluiuenoientacheualtotecelemeismeuoie.etqantlicheuallaprochierentiluirētleseinthomeqiestoituestuzdenoirsuestemenz.asfublezdenoireasfubleureqilidependoientduneparttresqesaterreqantlicheuallesuirentsienorentgrantpoorqilꝯmencierentaarbreraeslanciersenuoloientfoiraforce.cilqidesusseoientlestindrentamalespeinessifurentmoltcorrociezmoltairie:deceqillorcouenoitferedemorancedelorbestesqisiestoientespoentees.lorsdescendirentꝑgrantiresicorurentseureauseinthome.leꝯmencierentaferirabatre.alaidegiermoltdurementparparolemesliseinzhomnedisoitunseulmotdeceestoientcilesprisdeplusgrantderueriecarilcuidoientqildespisistlescousqillidonoientetqilnelessentistmie.lorsuenimesapresleseinthomesiletrouamestoutdescire.toutensanglētegisantaterreaussintꝯmetotpasme.lorslepreismes,silemeimesseursỏasnepuissinosenalames.etcilqilaidengielauoient.uindrentalorbestes,sisencuidierentalermesilnelesmeussentpornulepeinecarilestoientcoiesaussicomseilfussentfichiesenterre.etillesꝯmencierentabatredebastons.deuergesmesriensnelorualoitcarilnelespooientmouoirnoientplusqeseilfussentdepierre.lichetifhomenesauoientqilpeussentfeirecarilpooientiabiensauoirueoir:qeceestoitparlauolentedenostresignor.dontcomencierentaenquerreademanderqicilestoitqilbatuauoienttantqeparceusqilatrespassoient.sorentilapertemententendirent.qeceestoitseinzmartins.dontsorentiluraiementqeporcenesepooientilmouoir.touterranmentsenuindrentapresnosgrantaleureapiemoltrepentāzmoltconfuzdelormesfet.etqantilparuindrentdeuantleseinthomeilselessierentcheoirasespiezsiliproierentpardondelorfeloniescarilsauoientbienqausicomilfistarresterlorbesteseuistilpuissanceqelaterrelestrangloutisttozuisouilfussentpierresdeuenuzenmilechampolorbestesestoientarrestees.meᷤpordeulordonastpooirdalerloruoiessilorpardonastcestmesfaitparsadocorparsamisericorde.eteincoisqiluenissentanosnosauoitliseinzhomditqilnesepooientmouoirnepartir.etdontlorpardonamoltdocementmlt̉benignement.dontreuindrentcilalorbestes,sisenralerent.decemesouientbien,fetgallusaseuerumsoncompaignonapostumienqilescoutoientqilsoloitdire.qeonqespuisceiorqilrechutleueschielasignorienotsigrantuertucomilauoitdeuanteue.etporcepoesuozbiensauoirqilfistmeintbelmi--racle.pluiseursgranzuertuzdementieresqilfumoinesqegairesdegenzneuirentqantilenatantesfetesenleueschieqenoztozauonsueu.etneporqantmoltdesesoeuresfurentꝯneuesausiecleauꝯmencementqineporentestrecelees.tantenfistqelennensauroitmielenombreqilfistcelercela:porceqilnenuoloitmieaqerrelamondeineloenge.etiesaibienqedeuantceqilfusteuesqesresuscitail.ii.morzsicomtesliures,seuere,leraconteplenierementetpuisqilfueuesqesenresuscitailunseulem̅tdontiemesmerueilmoltꝯmenttucetrespassas.qetunenfeismentionentonliure.etdecesuiieueraistiesmoingseuuosendoutezsiuosconterecomentcefuenquelemaniere.	apréscenotmielonctens.senalaseinzmartinsetnosensambleolui.aunevileenseveschiéporvisiterceusqicrestienestoient.etpormostrerlaparolenostresignorsicomillavoitacostume.sicomnosalamestotelavoieensamblenosdemoramesarriere,nesaiporquelchoseetilsenaladevantnostozmoutgrantpiece.qantilnosotmouteslongiésilgarda,sivitvenirunegranttorbedegent:qiversluivenoientachevaltotecelemeïsmevoie.etqantlichevallaprochierentetilvirentleseinthomeqiestoitvestuzdenoirsvestemenz.etasfublezdenoireasfubleüreqilidependoientduneparttresqesaterreqantlichevallesvirentsienorentgrantpoorqilconmencierentaarbreretaeslancieretsenvoloientfoïraforce.cilqidesusseoientlestindrentamalespeinesetsifurentmoltcorrociezetmoltaïrié:deceqillorcovenoitferedemorancedelorbestesqisiestoientespoentees.lorsdescendirentpargrantiresicorurentseureauseinthome.etleconmencierentaferiretabatre.etalaidengiermoltdurementparparolemesliseinzhomnedisoitunseulmotetdeceestoientcilesprisdeplusgrantderveriecarilcuidoientqildespisistlescousqillidonoientetqilnelessentistmie.lorsvenimesaprésleseinthomesiletrovamestoutdesciré.ettoutensanglentégisantaterreaussintconmetotpasmé.lorslepreïsmes,silemeïmesseursonasneetpuissinosenalames.etcilqilaidengiélavoient.vindrentalorbestes,sisencuidierentalermesilnelesmeüssentpornulepeinecarilestoientcoiesaussicomseilfussentfichiésenterre.etillesconmencierentabatredebastons.etdevergesmesriensnelorvaloitcarilnelespooientmovoirnoientplusqeseilfussentdepierre.lichetifhomenesavoientqilpeüssentfeirecarilpooientjabiensavoiretveoir:qeceestoitparlavolentédenostresignor.dontcomencierentaenquerreetademanderqicilestoitqilbatuavoienttantqeparceusqilatrespassoient.sorentilapertementetentendirent.qeceestoitseinzmartins.dontsorentilvraiementqeporcenesepooientilmovoir.touterranmentsenvindrentaprésnosgrantaleüreapiémoltrepentanzetmoltconfuzdelormesfet.etqantilparvindrentdevantleseinthomeilselessierentcheoirasespiezsiliproierentpardondelorfeloniescarilsavoientbienqausicomilfistarresterlorbesteseuïstilpuissanceqelaterrelestrangloutisttozvisouilfussentpierresdevenuzenmilechampolorbestesestoientarrestees.mespordeulordonastpooirdalerlorvoiesetsilorpardonastcestmesfaitparsadoçoretparsamisericorde.eteinçoisqilvenissentanosnosavoitliseinzhomditqilnesepooientmovoirnepartir.etdontlorpardonamoltdocementetmoutbenignement.dontrevindrentcilalorbestes,sisenralerent.etdecemesovientbien,fetgallusaseverumsoncompaignonetapostumienqilescoutoientqilsoloitdire.qeonqespuiscejorqilrechutleveschiéetlasignorienotsigrantvertucomilavoitdevanteüe.etporcepoésvozbiensavoirqilfistmeintbelmi--racle.etpluiseursgranzvertuzdementieresqilfumoinesqegairesdegenznevirentqantilenatantesfetesenleveschiéqenoztozavonsveü.etneporqantmoltdesesoevresfurentconneüesausiecleauconmencementqineporentestrecelees.ettantenfistqelennensauroitmielenombreqilfistceleretcela:porceqilnenvoloitmieaqerrelamondeineloenge.etjesaibienqedevantceqilfustevesqesresuscitail.ii.morzsicomteslivres,severe,leraconteplenierementetpuisqilfuevesqesenresuscitailunseulementdontjemesmerveilmoltconmenttucetrespassas.qetunenfeïsmentionentonlivre.etdecesuijeveraistiesmoingsevosvosendoutezetsivosconterécomentcefuetenquelemaniere.
ilauintqenosmeumesporalerauchasteldechartresneuossaimiebiencerteinementadireporquelchose.sicomnosenalionssitrespassamesparmiuneuile:qitoteestoitdegenzpleineqiihabitoient.apresencontramesunegranttorbedegentqituitestoientpaiencarenceleuilenauoitencoreadonccrestienencelehore.meslipaiensassamblerentdetotesparzqantiloirentparlerdeseintmartincarilauoientsouentoiconterretrairedeseshautesoeuresdeseshautesmiracles.qnͣtseinzmartinssentisotlesgranzgenzporluiassembleesilsentibiensotparleseintesperit.qeiluecporroitilbienoureraucunechoseesploiter.dontlorꝯmencaapreechieraanoncierlaparolenostresignoragemiraplorer.porceqetantdegenzcomlaauoitassambleneregnoissoientlorsalueorqifezlesauoitcreez.sicomnosestionsauironezdetotesparzdespaiensunefemeuintaportantlecorsdesonfilqimorzestoitsitendisesmeīsuersleseinthomesiꝯmencaahautesuoizacrieradirebeaussire,nossauonsbienqetuiesamisdeuieteproiqetumerendesmōfilcarienenauoieplusqecestuisiensuimoltdesconfortee.tuitcilqilaestoientassam--blecomencierentaproierleseinthome:porlafemeqilueoientsidolentesitristre.lorspristseinzmartinslecorsdelenfantasesmeins,sisagenoillaaterresiꝯmencasesorissonsafeireadire.etaprescequilotoreilseleua.lauiereuintmeintenātenlenfantparlauolentenostresignorsilerendiliseinzhomalamereqimoltenfuioieuselie.dontcomencatrestozlipueplesqilaestoitaregarderuersleciel:areiehirdelorboches:qilnestoitautresdexqeiesucrizetapresselessierenttuitcheoiraspiezdelseinthome.licomencierēttuitaproierensambleqillesfeistcrestienernesetariastmieqilnemeistachascunsameinsilesprēsignasttoz.puissetornauersnossinosdistqecenestoitmiesanzresonqillesauoitprēsigniezenlachampaignecarlasoloientestrelimartircoronezqantilsedepartoientdecesteuie:ilaloientenꝑmenablegloire.	ilavintqenosmeümesporalerauchasteldechartresnevossaimiebiencerteinementadireporquelchose.sicomnosenalionssitrespassamesparmiunevile:qitoteestoitdegenzpleineqiihabitoient.aprésencontramesunegranttorbedegentqituitestoientpaiencarencelevilenavoitencoreadonccrestienencelehore.meslipaiensassamblerentdetotesparzqantiloïrentparlerdeseintmartincarilavoientsoventoïconteretretrairedeseshautesoevresetdeseshautesmiracles.qantseinzmartinssentietsotlesgranzgenzporluiassembleesilsentibienetsotparleseintesperit.qeiluecporroitilbienovreraucunechoseetesploiter.dontlorconmençaapreechieretaanoncierlaparolenostresignoretagemiretaplorer.porceqetantdegenzcomlaavoitassambléneregnoissoientlorsalveorqifezlesavoitetcreez.sicomnosestionsavironezdetotesparzdespaiensunefemevintaportantlecorsdesonfilqimorzestoitsitendisesmeinsversleseinthomesiconmençaahautesvoizacrieretadirebeaussire,nossavonsbienqetuiesamisdeujeteproiqetumerendesmonfilcarjenenavoieplusqecestuisiensuimoltdesconfortee.tuitcilqilaestoientassam--blécomencierentaproierleseinthome:porlafemeqilveoientsidolenteetsitristre.lorspristseinzmartinslecorsdelenfantasesmeins,sisagenoillaaterresiconmençasesorissonsafeireetadire.etapréscequilotoréilseleva.etlavierevintmeintenantenlenfantparlavolenténostresignorsilerendiliseinzhomalamereqimoltenfujoieuseetlie.dontcomençatrestozlipueplesqilaestoitaregarderversleciel:etarejehirdelorboches:qilnestoitautresdexqejesucrizetaprésselessierenttuitcheoiraspiezdelseinthome.etlicomencierenttuitaproierensambleqillesfeïstcrestieneretnesetarjastmieqilnemeïstachascunsameinetsilesprensignasttoz.etpuissetornaversnossinosdistqecenestoitmiesanzresonqillesavoitprensigniezenlachampaignecarlasoloientestrelimartircoronezqantilsedepartoientdecestevie:etilaloientenparmenablegloire.
dont	dont
parla	parla
postumiens	postumiens
a	a
gallum	gallum
sili	etsili
dist	dist
galle,tuasueincucartoutceqetumasditsaiiebiencroifermement:nusdeshermitesnedesanacorintes.neporentonqestantꝯmanderatotesleschosesdecestsieclenefere:comuostremartinsnonmietantsolementmesnostresaussint.ceestabondroitqeseueruslapareilleasapostresasprophetescarsesoeurestesmoignētqilestaeussamblablesdefoideuertu.mesieteproiqetudiesauantcarnosneporrionsoirmeilleurchosegalle,diauantceqiremeintdemartincardenuluinepuetlenconterplusgranzuertuz:neplusgnͣzmiracles.	galle,tuasveincucartoutceqetumasditsaijebienetcroifermement:etnusdeshermitesnedesanacorintes.neporentonqestantconmanderatotesleschosesdecestsieclenefere:comvostremartinsnonmietantsolementmesnostresaussint.etceestabondroitqeseveruslapareilléasapostresetasprophetescarsesoevrestesmoignentqilestaeussamblablesdefoietdevertu.mesjeteproiqetudiesavantcarnosneporrionsoïrmeilleurchosegalle,diavantceqiremeintdemartincardenuluinepuetlenconterplusgranzvertuz:neplusgranzmiracles.
gallus	gallus
respondi	respondi
siferaiieuolentiersmesceqeieuosuoelconterdireneuiciemiecarilertancoisauenuqeieuenisseensacompaigniemeslifezestmoltbonsaoir.nosseinzfreresqiifurentmontloeureconteedite.	siferaijevolentiersmesceqejevosvoelconteretdireneviçjemiecarilertançoisavenuqejevenisseensacompaigniemeslifezestmoltbonsaoïr.etnosseinzfreresqiifurentmontloevreconteeetdite.
enceltenzadonqeslifubesoinz,pornesaiqelchoseqilrequeistlesignordelaterreqiualentiensestoitapelez.qantcilsotqeseinzmartinsliuenoitrequerrechoseqilneliuoloitmiedonerilcomandaqelennelelessastmieentrerensonpalaissafemeqiestoitcrueledemalueseloẏ:liauoittrestornesonorgueilleuscorage.qilauoitmlt̉felon.qilneportasthoneurnereuerenceauseinthomesicomildeustfere.ensem̅talaseinzmartinacelorguilleusprinceunefoizautremesnipooitnoientesploitiernefeiretantqilseretraistasesleusarrieresiseuestidesheiresduressiesparstcendresorsonchief:sisetintdeboiuresdemengiers:sifistiorznuizassiduelmentsesorissonssesproieres.qantuintauseptiesmeiorquilotteluiedemeneeliangelesnostresignoruintdeuantluisiliꝯmandaqilalastseurementaupalez.qiltroueroitlesportesdelorgredesfermees.liorguilleusprincesseroitamoloies.dontuintliseinzhomparlaparoledelangelesialatantqiluintaupaleslihuisfurentouertnenusnefuencontre.apresalatātqilparuintauroi:qantilleuituenirilfumoutcorrociez:qelenlauoitladedenzlessieentrer.etqantliseinzhomlaproismailnesedeignaencontreluidrecier.etfeusespristmeintenantparlauolentenostresignorleroialsiege.sorqoiilseseoit:tozlesdrassiqilensentitresqasacharlachaleur.qantliroisuitceilsotbienqueceestoitparlahauteuertudeuinesiseleuaencontreseintmartinsilembracasifistmoltgrantioie.nenatendimietantqeliseinzhomliproiastceqilliestoituenuzreqerre,einzlifisttoterrantsanzproierelefistmengier.laresnaparmoltbonesparolesmoltbeles.etqantilsenuoutpartirilliuoutdonerpluseursdesesauoirs.mesliseinzhomneuoutnoientprendreeinzsepartidelasisentornaarrierecarilotbienfaitsabesoigneparlauolentenostreseignor.	enceltenzadonqeslifubesoinz,pornesaiqelchoseqilrequeïstlesignordelaterreqivalentiensestoitapelez.qantcilsotqeseinzmartinslivenoitrequerrechoseqilnelivoloitmiedonerilcomandaqelennelelessastmieentrerensonpalaisetsafemeqiestoitcrueleetdemalveseloy:liavoittrestornésonorgueilleuscorage.qilavoitmoutfelon.qilneportasthoneurnereverenceauseinthomesicomildeüstfere.ensementalaseinzmartinacelorguilleusprinceunefoizetautremesnipooitnoientesploitiernefeiretantqilseretraistasesleusarrieresisevestidesheiresduressiesparstcendresorsonchief:etsisetintdeboivresetdemengiers:etsifistjorzetnuizassiduelmentsesorissonsetsesproieres.qantvintauseptiesmejorquilottelviedemeneeliangelesnostresignorvintdevantluietsiliconmandaqilalastseürementaupalez.etqiltroveroitlesportesdelorgrédesfermees.etliorguilleusprincesseroitamoloiés.dontvintliseinzhomparlaparoledelangelesialatantqilvintaupaléslihuisfurentovertnenusnefuencontre.aprésalatantqilparvintauroi:etqantillevitvenirilfumoutcorrociez:qelenlavoitladedenzlessiéentrer.etqantliseinzhomlaproismailnesedeignaencontreluidrecier.etfeusespristmeintenantparlavolenténostresignorleroialsiege.sorqoiilseseoit:ettozlesdrassiqilensentitresqasacharlachaleur.qantliroisvitceilsotbienqueceestoitparlahautevertudevinesiselevaencontreseintmartinsilembraçaetsifistmoltgrantjoie.nenatendimietantqeliseinzhomliproiastceqilliestoitvenuzreqerre,einzlifisttoterrantsanzproiereetlefistmengier.etlaresnaparmoltbonesparolesetmoltbeles.etqantilsenvoutpartirillivoutdonerpluseursdesesavoirs.mesliseinzhomnevoutnoientprendreeinzsepartidelasisentornaarrierecarilotbienfaitsabesoigneparlavolenténostreseignor.
oruosaiiemoltcontedesesoeuͤs,fetgallusasescompaignonsetbienuosdeueroitsoffiremesieuoibiensi.uosuolontesuoscuersententis.aloeraentendrelesoeuresdelseinthomeqeieneloslessierieuoscontereitantcomliiorsauraduree.biensaciezacertesqelaouieuoiorendroitlefuerreenuozlizsimereuintamemoireqelifuerressorqoiseīzmartinsiutfistuertuzmiraclessicomieuozconteraisanzatariance.	orvosaijemoltcontédesesoevres,fetgallusasescompaignonsetbienvosdeveroitsoffiremesjevoibiensi.vosvolontésetvoscuersententis.aloeretaentendrelesoevresdelseinthomeqejeneloslessieretjevoscontereitantcomlijorsauraduree.etbiensaciezacertesqelaoujevoiorendroitlefuerreenvozlizsimerevintamemoireqelifuerressorqoiseinzmartinsjutfistvertuzetmiraclessicomjevozconteraisanzatarjance.
unschasteausestoitenlamarchedetoreineqiclaudiomasauoitnō.laestoituneeglisseouilauoitseinzhomesseintesuirgesqimoutdoucementseruoientnostresignor.uniourauintqeseinzmartinstrespassalasiseherberialaiutporamonesterlesseintesdamoiselesdebienferedemenerseinteuielendemeinqantilsenfupartisellesuindrentenlachambreouilauoitgeu:pristrentlestreinouilauoitgeusilepartirentauplusdroitqeelessorentporent.apresceunpoidetermeotenlauileunhomecuilideablesentraelcorsqidemenoitgrantfreorgrantderuerie.lunedesdamoiselesqidecelestreindontieuosaideuantconte:auoitsapartielefistprendresilefistauderuemetreentorlateste.tantostnipotlideablesarrestereinzissideluaisselouilestoitentrez:cilfugarizdeliuresdelamaleauenture.	unschasteausestoitenlamarchedetoreineqiclaudiomasavoitnon.laestoituneeglisseouilavoitseinzhomesetseintesvirgesqimoutdoucementservoientnostresignor.unjouravintqeseinzmartinstrespassalasiseherberjalaetjutporamonesterlesseintesdamoiselesdebienfereetdemenerseintevielendemeinqantilsenfupartisellesvindrentenlachambreouilavoitgeü:etpristrentlestreinouilavoitgeüsilepartirentauplusdroitqeelessorentetporent.aprésceunpoidetermeotenlavileunhomecuilideablesentraelcorsqidemenoitgrantfreoretgrantderverie.lunedesdamoiselesqidecelestreindontjevosaidevantconté:avoitsapartielefistprendresilefistaudervémetreentorlateste.ettantostnipotlideablesarrestereinzissidelvaisselouilestoitentrez:etcilfugarizetdelivrésdelamaleaventure.
apresceenceltensmeismesauintqenosrepairamesdetrieuessicomnosuenionstotelauoieuneuachederueecuilideablesfesoitenragierauoitdeguerpisonfoucsaꝯpaignielaauoitpluisorsgenznaurezasescornescruelmentbleciez.elenoscomencaaaproismierdepres.cilqilasiuoientdeloīg.nosꝯmencierentahautesuoizacrieradireqenosnosgardissonselenosaprocha,sinosfistmoltlaidechieremoltcrueleseinsmartinsleuasameinencontre.siliꝯmandaqelefusttotecoie.ettantostarrestalauachesicoieqelenesemouoitnenecrolloit.dontregardaseinzmartinssiuitqelideablesliseoitsorledosenmoutlaidefigure.lorslidistliseinzhom:morteusenemisdeparttoidecestebestesigardeqetuplusnelatormentes.meintenantsendeꝑtilideablesqeplusniarrestaneniosastdemorerparlaparoledeseintmartin.adoncnedefaillimiesensenlabesteqelenentendistbienseustqeeleestoitparleseinthomdeliuree.meintenantlicheiaspiez.liseinzhomlicomandaqeleralastasonfoucasacompaignie.elesifistfupluspesibledetouteslesautres.etcefufeteltensquilsemistencontrelesautresflambesdeltempleqiardoitporlamesonrescorresicomeseuerusleraconteensonliure.ettu,postumien,lasleuparpluisorsfoizsicomiecuit.setunaslaparoleentenduetuasleliure,silelirasqanttoiplairanosdironsauātleschosesqisonttrespasseesetquinontmieesteoies.	aprésceenceltensmeïsmesavintqenosrepairamesdetrievessicomnosvenionstotelavoieunevachederveecuilideablesfesoitenragieravoitdeguerpisonfoucetsaconpaignieetlaavoitpluisorsgenznavrezasescornesetcruelmentbleciez.etelenoscomençaaaproismierdepres.cilqilasivoientdeloing.nosconmencierentahautesvoizacrieretadireqenosnosgardissonselenosaprocha,sinosfistmoltlaidechiereetmoltcrueleseinsmartinslevasameinencontre.etsiliconmandaqelefusttotecoie.ettantostarrestalavachesicoieqelenesemovoitnenecrolloit.dontregardaseinzmartinssivitqelideablesliseoitsorledosenmoutlaidefigure.lorslidistliseinzhom:morteusenemisdeparttoidecestebesteetsigardeqetuplusnelatormentes.meintenantsendepartilideablesqeplusniarrestaneniosastdemorerparlaparoledeseintmartin.etadoncnedefaillimiesensenlabesteqelenentendistbienetseüstqeeleestoitparleseinthomdelivree.meintenantlicheïaspiez.etliseinzhomlicomandaqeleralastasonfoucetasacompaignie.etelesifistetfupluspesibledetouteslesautres.etcefufeteltensquilsemistencontrelesautresflambesdeltempleqiardoitporlamesonrescorresicomeseverusleraconteensonlivre.ettu,postumien,lasleüparpluisorsfoizsicomjecuit.etsetunaslaparoleentenduetuaslelivre,silelirasqanttoiplairaetnosdironsavantleschosesqisonttrespasseesetquinontmieestéoïes.
uniorauintqenosalionsꝑleueschieensambleporuisiterlesprestresceusqicrestiensestoientsicomeuesqesdoitferesicomnosuenimesenmiunegrantchampaignenosueimesuenirunegrantcompaigniedeueneors.chiensdeuantqiauoientunlieureacoilli.lachampaigneestoitlongeleelilieureᷤnesauoitoufoiragarissoncarlichienlesiuoientsipresqillicouenoitꝑmeintesfoizꝑmielsfeiresestors.porlamorteschiuerqimoutliestoitproceine.qantliseinzhomuitentelperillabesteletesienotgrantpitiesicomandaaschiensqilplusnelesiuissent.qillenlessasentalerfoiraguerisson.meintenantarresterentlichienasapremereineparoleseuoslesueissiezuoscuidissiezqilfussentliiez:ouquilfussētfermementatachiezalaterre.einsieschapalilieuresalaaguerison.orpoezuosbiensauoirqesesparolesauoientgrantuertugrantforce.apressenretornerentlichienparsonꝯmandementarriere.	unjoravintqenosalionsparleveschiéensambleporvisiterlesprestresetceusqicrestiensestoientsicomevesqesdoitferesicomnosvenimesenmiunegrantchampaignenosveïmesvenirunegrantcompaigniedeveneors.etchiensdevantqiavoientunlievreacoilli.lachampaigneestoitlongeetleeetlilievresnesavoitoufoïragarissoncarlichienlesivoientsipresqillicovenoitparmeintesfoizparmielsfeiresestors.porlamorteschiverqimoutliestoitproceine.qantliseinzhomvitentelperillabesteletesienotgrantpitiésicomandaaschiensqilplusnelesivissent.etqillenlessasentaleretfoïraguerisson.meintenantarresterentlichienasapremereineparoleetsevoslesveïssiezvoscuidissiezqilfussentliiez:ouquilfussentfermementatachiezalaterre.einsieschapalilievresetalaaguerison.orpoezvosbiensavoirqesesparolesavoientgrantvertuetgrantforce.apréssenretornerentlichienparsonconmandementarriere.
enceltensestoitunscheualiersrenduzenuneabeieporestremoinesiauoitenunepartiedelabeiefeteunecelleloingdesautresporceqiluoloitestresolitairesaussintcomunshermites.quantiliotestelonctenslienemisqimoutestoituiseuslemistenpensee.qesafemeqienuneabeieestoitdedamoiselesouseinzmartinslauoitmiseseroitboneensambleolui.sicomilhabitoitencelleuseulement,liestoitiasapenseeesmeueqilliuoloitauoirsansfalle.dontrequistcelifoushermitesaseintmartin.silidistceqilpensoitensoncorage.liseinzhomneliuoutotroierennulemanierecarnestoitmieresonsdemetrefemeensambleomoinecarcilnestoitmiesesmarizneelesespouse.audaerreinqantlicheualierslotmoutenchaucie:illiotditqecilproposementnelipooitnoientnuirecarbienseustqilneuoloitselesolaznondesafeme:nenecremistmieqilsedeuistmetreencharneleuolentezcarilestoitcheualiersiesucrist.elemeismesauoitiureamenerseinteuiemessoffristlaliseinzeuesqesensambleoluicarilnesauroituiurenemenerseinteuiesanzlidoncparlaseinzmartinsaucheualiersilidistfustuonqesenestornenbataillecillirespondi:iaimaintesfoizesteenconroienbataille.seīzmartinslidist:ormedidonqes,setufusonqesenconroi.qetuueissesapareilleordeneporcombatrefemeestreneembatailleoutucombatisses.qantlicheualiersoieinsiparlerleseinteuesqeilsapercutqilauoitpenseditfolie,sienotuergoigne.lorsrendigracesanostresignordecequilnelilutmieafereloeureqilauoitempēse.dontsetornaseinzmartinsuersnos.sinosdistqefemenedeuoitmieestreensambleoleshomesenbatalleneenconroineencompaigniesdecheualiersarmezainzsedoittenirensamesontoutecoiecarfemesestoientassambleesensambleotorbesdegenzarmeesporcombatrealorenemislorenemilesdespiroientplusqesenuleneniauoit.licheualiersdoitestremisenconroiencompaignie.sisedoitcombatreenlachampaignelafemesecontiegnededenzsameson:lasoittotecoiecarlaaquiertelegloireouellegardesachaesteqantlihomniestmie.ceestlapremiereuertuzdelabstinance.siestuictoiredeluidedesirrierqeleneleuoie.etencoremesouientbien,fetgallꝰaseuerumsoncompaignon,sicuicqetutenremembresqeseinzmartinsnossoloitpreeschieramonesterduneuirgeqisisetraioitarrieredetozleshomesdelmondeqelenenuoloitnulueoirneisseintmartinneuoutelleesgarderqnͣtillalaunefoizporuisitersiuosdiraicomentilialaparqueleauenturesicōilmeismeslenosracontadist.	enceltensestoitunschevaliersrenduzenuneabeïeporestremoinesiavoitenunepartiedelabeïefeteunecelleloingdesautresporceqilvoloitestresolitairesaussintcomunshermites.quantiliotestélonctenslienemisqimoutestoitviseuslemistenpensee.qesafemeqienuneabeïeestoitdedamoiselesouseinzmartinslavoitmiseseroitboneensambleolui.sicomilhabitoitencelleuseulement,liestoitjasapenseeesmeüeqillivoloitavoirsansfalle.dontrequistcelifoushermitesaseintmartin.etsilidistceqilpensoitensoncorage.etliseinzhomnelivoutotroierennulemanierecarnestoitmieresonsdemetrefemeensambleomoinecarcilnestoitmiesesmarizneelesespouse.audaerreinqantlichevalierslotmoutenchaucié:etilliotditqecilproposementnelipooitnoientnuirecarbienseüstqilnevoloitselesolaznondesafeme:nenecremistmieqilsedeuïstmetreencharnelevolentezcarilestoitchevaliersjesucrist.etelemeïsmesavoitjuréamenerseinteviemessoffristlaliseinzevesqesensambleoluicarilnesauroitvivrenemenerseinteviesanzlidoncparlaseinzmartinsauchevalieretsilidistfustuonqesenestornenbatailleetcillirespondi:jaimaintesfoizestéenconroietenbataille.seinzmartinslidist:ormedidonqes,setufusonqesenconroi.qetuveïssesapareilléetordenéporcombatrefemeestreneembatailleoutucombatisses.qantlichevaliersoïeinsiparlerleseintevesqeilsaperçutqilavoitpenséetditfolie,sienotvergoigne.lorsrendigracesanostresignordecequilnelilutmieafereloevreqilavoitempense.dontsetornaseinzmartinsversnos.etsinosdistqefemenedevoitmieestreensambleoleshomesenbatalleneenconroineencompaigniesdechevaliersarmezainzsedoittenirensamesontoutecoiecarfemesestoientassambleesensambleotorbesdegenzarmeesporcombatrealorenemislorenemilesdespiroientplusqesenuleneniavoit.lichevaliersdoitestremisenconroietencompaignie.etsisedoitcombatreenlachampaigneetlafemesecontiegnededenzsameson:etlasoittotecoiecarlaaquiertelegloireouellegardesachaestéqantlihomniestmie.etceestlapremierevertuzdelabstinance.etsiestvictoiredeluidedesirrierqelenelevoie.etencoremesovientbien,fetgallusaseverumsoncompaignon,etsicuiçqetutenremembresqeseinzmartinsnossoloitpreeschieretamonesterdunevirgeqisisetraioitarrieredetozleshomesdelmondeqelenenvoloitnulveoirneisseintmartinnevoutelleesgarderqantillalaunefoizporvisitersivosdiraicomentilialaetparqueleaventuresicomilmeïsmeslenosracontaetdist.
uniorauintqiltrespassapresdelleuouladamoiselemanoitqimenoitmoltseinteuiesisepensaliseinzeuesqesqiliroitcelepuceleuisiterhonorer:qiestoitdesihautemeriteuersnostresignorcarilauoitsouentesfoizoiparlerdesafoidesareligion.nosensiuimesleseinthome.sicuidamesqelauirgesedeustmoltesleechierdesauenue.qecefustencoretesmoingdesagrantuertu:qeliseinzhomlafustuenueueoiruisitermesellenalaᷤchaonqeslesforzliiensqeleauoitasoncuermisasaueuecaronqesneleuoutregarderneueoir.seinzmartinsdemandaporquelchoseceestoit.qeladamoiseleneseuoutaluidemostrer.uneautrefemelidistqeleneuoloitonqesregarderneueoirnulhometerrienencestmonde.qantseinzmartinsloiilsendepartimoutliezmoltioieus,ceqemeintautrehomenefeissentmie.orpoezusauoirentendreuostuitqicrestienestesqeceleuirgeestoitmoutglorieuse.qinesoffroitmieqenushomlaueistneisseinzmartīsqiestoitseintismeseuesqes.etseinzmartinsfubeneuresqinesecorrocamiedeceqeleneselessaaluiueoireinzloamoltnostresignor:porlagrantuertuqilliauoitdonee:deceqeledonoitexampleacelesqiapresliestoientauenir.etqnͣtnosfumesdeladepartizlanuisnosuītsiproceineqilnoscouintgesiraunepetiteuiletenonmiemoltloingdelaoulaseinteuirgemanoitcelenuitenuoiaelleauseinthomesacheinture.illarecut:neonqesmaisnauoitreceudondefeme.ilnerefusanulechoseqelelienuoiasteinzdisoitqenusprestresnedeuoitrefusersesdonscarelleseroitdeuantpluseursptresenparmenablegloire.orproiietouteslesuirgescelesqiuuelentgardercontinence.qe,semauueshomesuoelentueniraelles:dontelessedoutent,qelescloentlorhuislorportes:meesmementasbonsporlesmauuesforsmettreceestqelesnētiegentanusparole.etporcesacetouslimondesqelaseinteuirgenelessamiealiuenirseintmartin.etquelsprestresfustcequelseuesqes:qinetenistcestechoseahonteouaoutrageselenlieustfeteseseinzmartinsnonetqifustceqinefustesmeuzenuerslaseinteuirgeensigrantireqilneletenistacruauteouaescomenieecenefustnus,sicomiecroi,qifustentoutlemonde.mestantuosdiraiiedeliqeliseintangelenostresignorlauisitoientmoutsouent.etaussifaissoientilleseinthome.dontieuosaicontelauiesicomietedirai,postumienparueraitesmoing.dontieauraigarantissetelecomseuerumnostrecompaignonqiciententamaparole.	unjoravintqiltrespassapresdelleuouladamoiselemanoitqimenoitmoltseinteviesisepensaliseinzevesqesqiliroitcelepucelevisiterethonorer:qiestoitdesihautemeriteversnostresignorcarilavoitsoventesfoizoïparlerdesafoietdesareligion.nosensivimesleseinthome.etsicuidamesqelavirgesedeüstmoltesleechierdesavenue.etqecefustencoretesmoingdesagrantvertu:qeliseinzhomlafustvenueveoiretvisitermesellenalaschaonqeslesforzliiensqeleavoitasoncuermisetasaveüecaronqesnelevoutregarderneveoir.seinzmartinsdemandaporquelchoseceestoit.qeladamoiselenesevoutaluidemostrer.etuneautrefemelidistqelenevoloitonqesregarderneveoirnulhometerrienencestmonde.qantseinzmartinsloïilsendepartimoutliezetmoltjoieus,ceqemeintautrehomenefeïssentmie.orpoezvossavoiretentendrevostuitqicrestienestesqecelevirgeestoitmoutglorieuse.qinesoffroitmieqenushomlaveïstneisseinzmartinsqiestoitseintismesevesqes.etseinzmartinsfubeneürésqinesecorroçamiedeceqeleneselessaaluiveoireinzloamoltnostresignor:porlagrantvertuqilliavoitdonee:etdeceqeledonoitexampleacelesqiaprésliestoientavenir.etqantnosfumesdeladepartizlanuisnosvintsiproceineqilnoscovintgesiraunepetiteviletenonmiemoltloingdelaoulaseintevirgemanoitetcelenuitenvoiaelleauseinthomesacheinture.etillareçut:neonqesmaisnavoitreceüdondefeme.ilnerefusanulechoseqelelienvoiasteinzdisoitqenusprestresnedevoitrefusersesdonscarelleseroitdevantpluseurspretresenparmenablegloire.orproijetouteslesvirgesetcelesqivuelentgardercontinence.qe,semauvéshomesvoelentveniraelles:dontelessedoutent,qelescloentlorhuisetlorportes:meesmementasbonsporlesmauvésforsmettreceestqelesnentiegentanusparole.etporcesacetouslimondesqelaseintevirgenelessamiealivenirseintmartin.etquelsprestresfustceetquelsevesqes:qinetenistcestechoseahonteouaoutrageselenlieüstfeteseseinzmartinsnonetqifustceqinefustesmeüzenverslaseintevirgeensigrantireqilneletenistacruautéouaescomenieecenefustnus,sicomjecroi,qifustentoutlemonde.mestantvosdiraijedeliqeliseintangelenostresignorlavisitoientmoutsovent.etaussifaissoientilleseinthome.dontjevosaicontélaviesicomjetedirai,postumienparveraitesmoing.dontjeauraigarantissetelecomseverumnostrecompaignonqiciententamaparole.
uneautrefoizauintqeieseuerus,sicomilsetbienbienlensouientestionsaluisdesacelleqicloseestoit.neniosionshurternenoisefereainziestionsaussicoiaausigrantreuerence,comsecefustunemesondangelesqenosesgardissions.biensaciezqeliseinzhomnenosisauoitmie.sicomnosseionsla:atendionsentelmanierenosoimeslesuoizlamurmuredepluiseurshomes,cenossambla,qiparlassentdonteumesgrantpoor:fumesesbahiporceqenoscuidamesqecefustaucunediuinechose.aprescebienlespacede.ii.heures.ouriseinzmartinssacelle,siuintanos.dontparlaseuerusaluisicomcilqipluspriuezenestoitqenusautres.siliꝯmencaaproierqillideistqelepoorceestoitqenosauionsambesdeussentue:aquiilauoitparlededenzsacellecarilnossambloitqenosiauonsoidedeforsleshuislaounousestionssonsuoizdenesaiquelsgenzqiparloient.dontsetariailmoutdetelchoseanosdiremesilnestoitnulechoseqeseuerꝰqiciestuousistsauoirqilnelideistdeceqilliauenoitsinosdistjeuosdiraichosesqimalcreablessamblerontmescesacedexieneuosmentiraimie.siuosproiqeuosneditesanuluiceqeieuosdirai.seinteagniesseintececileseintemariemagdalene.resnierentamoienmacelleꝑlerent.dontnospristaraconterlorformeslorbeautesdeloruiaireslabitdechascunebiēsachiezqelesniestoientmietantsolementdelioruenuesmeschascunioriuenoientellesporluiuisitersicomilnosregehidist.etsinedenioitmieqeilneustsouentseītpereseintpol,lesbeneoisapostres.etqnͣtlideableuenoientaluiporluitempterdecoiuresicomilfissentmeintesfoizilchacoitchascunblasmoitparsonproprenon.etbiensacestu,postumien,qesilneustsignͣtuertuenluiilnepeustmieestreauantmiᷤnepreechiezparnosparsigrantgloire.etsepluseursgenzsontmalcreablesdesseintesoeuresqilafetesienemenesmerueilmiecarnosueonslespluseursenzeltensdore:qinecroientleseuuangilesnossentimesbienesprouamesparmeintesfoisqeseinzmartinsuitlesangelesmlt̉souent.oruosconteraiiedeluiunegrātchosemoltmeruilleusesilentendez.	uneautrefoizavintqejeetseverus,sicomilsetbienetbienlensovientestionsaluisdesacelleqicloseestoit.neniosionshurternenoisefereainziestionsaussicoietaausigrantreverence,comsecefustunemesondangelesqenosesgardissions.etbiensaciezqeliseinzhomnenosisavoitmie.sicomnosseionsla:etatendionsentelmanierenosoïmeslesvoizetlamurmuredepluiseurshomes,cenossambla,qiparlassentetdonteümesgrantpoor:etfumesesbahiporceqenoscuidamesqecefustaucunedivinechose.apréscebienlespacede.ii.heures.ovriseinzmartinssacelle,sivintanos.dontparlaseverusaluisicomcilqiplusprivezenestoitqenusautres.etsiliconmençaaproierqillideïstqelepoorceestoitqenosavionsambesdeussentue:etaquiilavoitparlédedenzsacellecarilnossambloitqenosiavonsoïdedeforsleshuislaounousestionssonsetvoizdenesaiquelsgenzqiparloient.dontsetarjailmoutdetelchoseanosdiremesilnestoitnulechoseqeseverusqiciestvousistsavoirqilnelideïstdeceqilliavenoitsinosdistjevosdiraichosesqimalcreablessamblerontmescesacedexqejenevosmentiraimie.etsivosproiqevosneditesanuluiceqejevosdirai.seinteagniésetseintececileetseintemariemagdalene.resnierentamoienmacelleetparlerent.dontnospristaraconterlorformesetlorbeautésdelorviairesetlabitdechascuneetbiensachiezqelesniestoientmietantsolementdeljorvenuesmeschascunjorivenoientellesporluivisitersicomilnosregehietdist.etsinedenioitmieqeilneüstsoventseintpereetseintpol,lesbeneoisapostres.etqantlideablevenoientaluiporluitempteretdeçoivresicomilfissentmeintesfoizilchaçoitchascunetblasmoitparsonproprenon.etbiensacestu,postumien,qesilneüstsigrantvertuenluiilnepeüstmieestreavantmisnepreechiezparnosparsigrantgloire.etsepluseursgenzsontmalcreablesdesseintesoevresqilafetesjenemenesmerveilmiecarnosveonslespluseursenzeltensdore:qinecroientleseuvangilesetnossentimesbienetesprovamesparmeintesfoisqeseinzmartinsvitlesangelesmoutsovent.etorvosconteraijedeluiunegrantchoseetmoltmervilleusesilentendez.
uniorauintqalacitedelmansotassambleunconcilegrantmerueilleus.deuesqes,dabbes,deprestes,declers.qiuenuziestoientdetotesparz.acelsenneneuoutmiealerliseinzhommesneqedentcovoitotilmoltqeleniauoitfaitdit.adoncestoitseuerusenunenefensambleoluiꝑauenture.sideuionsalerennesaiqelleupareuwe.liseinzhomsemistelpluspaisibleleudelanefloingdesautres.lauintaluilian--gelesnostresignor.silicontadist.quelenauoitfetauconcile.etapresdemandamesnostantenqeismes.qenosenfumesbiencertein.qaceliorauoitesteliconciles.einsiauoientalelesparoleslesoeurescomillesnosauoitconteesdites.comliangelesliauoitretretesaprisses.	unjoravintqalacitédelmansotassambléunconcilegrantetmerveilleus.devesqes,dabbés,deprestres,declers.qivenuziestoientdetotesparz.etacelsennenevoutmiealerliseinzhommesneqedentcovoitotilmoltqeleniavoitfaitetdit.adoncestoitseverusenunenefensambleoluiparaventure.etsidevionsalerennesaiqelleupareuwe.liseinzhomsemistelpluspaisibleleudelanefloingdesautres.lavintaluilian--gelesnostresignor.etsilicontaetdist.quelenavoitfetauconcile.etaprésdemandamesnostantetenqeïsmes.qenosenfumesbiencertein.qaceljoravoitestéliconciles.eteinsiavoientalélesparolesetlesoevrescomillesnosavoitconteesetdites.etcomliangelesliavoitretretesetaprisses.
or	or
parole	parole
seuerus	severus
si	etsi
distsi	distsi
com	com
gallus	gallus
auoit	avoit
dites	dites
cez	cez
paroles	paroles
il	etil
nes	nes
ꝑ	par
auoit	avoit
encore	encore
mie	mie
bien	bien
acomplies	acomplies
uns	uns
enfes	enfes
uint	vint
qiestoit	qiestoit
nostre	nostre
acointes	acointes
laou	laou
nos	nos
estions	estions
si	etsi
nos	nos
dist	dist
qe	qe
refrigerius	refrigerius
li	li
prestres	prestres
estoit	estoit
defors	defors
les	les
huis	huis
dela	dela
meson	meson
si	etsi
uenoit	venoit
anosdont	anosdont
comencames	començames
nous	nous
adouter	adouter
lequel	lequel
nos	nos
ferionsou	ferionsou
nous	nous
orrions	orrions
encor	encor
auant	avant
les	les
paroles	paroles
qe	qe
gallus	gallus
nos	nos
contoitou	contoitou
nos	nos
irions	irions
auant	avant
encontre	encontre
le	le
prestre	prestre
qi	qi
estoit	estoit
nostre	nostre
chiers	chiers
amis	amis
qi	etqi
uenoit	venoit
anos	anos
por	por
compaignie	compaignie
dont	dont
parla	parla
gallus	gallus
si	etsi
dist	dist
senosnelessionsmiecesteparoleporlauenementdelprestreqicinosestuenusreqerresinosdestreintlanuitqitantestaprochieqenosladeguerpissomes.porceqeienepuismiehuipardire.toteslesuertuzdeseintmartinceqeuozenauezoiuossoffisse.tresqademeinqeieuosendirailautrepartie.	senosnelessionsmiecesteparoleporlavenementdelprestreqicinosestvenusreqerresinosdestreintlanuitqitantestaprochieqenosladeguerpissomes.etporceqejenepuismiehuipardire.toteslesvertuzdeseintmartinceqevozenavezoïvossoffisse.tresqademeinqejevosendirailautrepartie.
qant	qant
nos	nos
oismes	oïsmes
gaullum	gaullum
einsi	einsi
parlerfet	parlerfet
seuerusnos	severusnos
nos	nos
leuames	levames
si	si
nos	nos
endepartimesqant	endepartimesqant
la	la
nuiz	nuiz
fu	fu
trespassee	trespassee
la	etla
matinee	matinee
fu	fu
uenue	venue
ie	je
dis	dis
a	a
gallum	gallum
qil	qil
se	se
leuast	levast
por	por
parconter	parconter
loeure	loevre
qil	qil
nos	nos
auoit	avoit
comencie	comencie
a	a
direcar	direcar
la	la
estoit	estoit
uenus	venus
postumiens	postumiens
	et
li	li
prestres	prestres
qi	qi
ersoir	ersoir
se	se
departi	departi
densamble	densamble
onous	onous
si	si
com	com
ie	je
parloie	parloie
einsi	einsi
a	a
gallum	gallum
il	etil
estoit	estoit
toz	toz
aparelliez	aparelliez
por	por
comencier	comencier
sa	sa
parole	parole
une	une
grant	grant
torbe	torbe
de	de
moines	moines
i	i
uint	vint
	et
ie	je
lor	lor
demandai	demandai
qil	qil
qeroient	qeroient
il	etil
me	me
respondirent	respondirent
qil	qil
auoient	avoient
oi	oï
dire	dire
qe	qe
gallus	gallus
auoit	avoit
ier	ier
tote	tote
ior	jor
conte	conté
les	les
granz	granz
uertuz	vertuz
de	de
seint	seint
martin	martin
qe	etqe
por	por
ce	ce
qe	qe
la	la
nuiz	nuiz
qi	qi
estoit	estoit
ꝑ	par
uenue	venue
li	li
auoit	avoit
fet	fet
deguerpir	deguerpir
sa	sa
parolesi	parolesi
la	la
deuoit	devoit
hui	hui
recomencier	recomencier
por	por
ce	ce
iestoient	iestoient
il	il
uenuz	venuz
car	car
il	il
uoloient	voloient
desiroient	etdesiroient
molt	molt
aoir	aoïr
loe	loe
ure	vre
de	de
si	si
haut	haut
martẏresi	martyresi
com	com
nos	nos
ꝑlions	parlions
ensi	ensi
ensamblesi	ensamblesi
nos	nos
dist	dist
len	len
qe	qe
une	une
granz	granz
torbe	torbe
degenz	degenz
del	del
siecle	siecle
estoient	estoient
defors	defors
les	les
huis	huis
et	et
si	si
prooient	prooient
molt	molt
que	que
len	len
les	les
lessast	lessast
ensamble	ensamble
onous	onous
entrer	entrer
por	por
oir	oïr
les	les
seintes	seintes
paroles	paroles
mes	mes
nos	nos
neumes	neümes
mie	mie
conseil	conseil
qe	qe
nos	nos
les	les
ilessissons	ilessissons
fors	fors
seulement	seulement
deuseucherium	deuseucherium
	et
celsum	celsum
qi	qi
conceles	conceles
estoienttuit	estoienttuit
li	li
autre	autre
si	si
furent	furent
mis	mis
arrieredont	arrieredont
nos	nos
asseimes	asseïmes
entor	entor
gallum	gallum
qui	qui
ensint	ensint
commenca	commença
sa	sa
parole	parole
biaussigneur,fetgallusuosestesciassamblepormoioirconterdirelesuertuzdeseintmartinmesbiensachiezqeieneuosendiraimieceqeieuosendizier.postumiensatentaescouternoueleschoses.ieliuoeildirelesoeuressicomelesauindrentporceqilanonciedieleschosesenorientaceusqiisonthabitentqenusnesenpuetcomparernenedoitaseintmartin.oruoudraicomencierdire.	biaussigneur,fetgallusvosestesciassamblépormoioïrconteretdirelesvertuzdeseintmartinmesbiensachiezqejenevosendiraimieceqejevosendizier.etpostumiensatentaescouternoveleschoses.etjelivoeildirelesoevressicomelesavindrentporceqilanoncieetdieleschosesenorientaceusqiisontethabitentqenusnesenpuetcomparernenedoitaseintmartin.orvoudraicomencieretdire.
enlacitedechartresauintuniorqenosiestions:qiliauoitunedamoiselede.xii.anz:quiestoitmuetresceqeleneeestoit.celeiamenasesperesauseinthome.siliꝯmencaaproierqillidesliastsalanguesiqeellereuïstsaparole.seinzmartinsrespondiauboenhomedist.qilnestoitmiedignesdeferesihauteoeuremesa.ii.euesqesqiestoientiluecassambleolui.dontliunsauoitnonualentiniensliautresuictricus:proiastreqeistcestechose.qnͣtceoirentlieuesqeillicomencierentaproierpardouceparoleensambleoleperedelapucele.qilfeistceqillirequeroient.liseinzhomnatariamieeinzcomanda.qelenmeistarrierelagrantpressedesgenzquilaestoientassamblez.qantcefufetnidemoraplusensambleoluiqeliduieuesqeliperesalademoisele.dontsecouchaliseinzhomenorissonssicomilsoloitfere.qantilotsorissonfineeildemandaunpouduile,silabenei:puisenmistenlabouchedelapuceleasondoit.dontlidemandalenonsonpere.etcelerespondiisnelem̅t.puiscomencaacriertotemplorantdeioie.etliperesporceqeceestoitlapremereineuoizqilauoitdesafilleonqesoiemes.lorsselessierentambeduicheoiraspiezdelseīthom.etcilqilaestoientsesbahirenttozdelgrantmiracle.orniauoitnuldenos,fetgallus,qicestechosemescroiecareuuagiusliprestresqiciestassamblezonosenpuetportertesmoingueritablecardeuātluifufeteloeurelemiracleeinsintcomieleuousconteai.	enlacitédechartresavintunjorqenosiestions:qiliavoitunedamoiselede.xii.anz:quiestoitmuetresceqeleneeestoit.celeiamenasesperesauseinthome.etsiliconmençaaproierqillidesliastsalanguesiqeellereuïstsaparole.seinzmartinsrespondiauboenhomeetdist.qilnestoitmiedignesdeferesihauteoevremesa.ii.evesqesqiestoientiluecassambléolui.dontliunsavoitnonvalentiniensetliautresvictricus:proiastetreqeïstcestechose.qantceoïrentlievesqeillicomencierentaproierpardouceparoleensambleoleperedelapucele.qilfeïstceqillirequeroient.liseinzhomnatarjamieeinzcomanda.qelenmeïstarrierelagrantpressedesgenzquilaestoientassamblez.qantcefufetnidemoraplusensambleoluiqeliduievesqeetliperesalademoisele.dontsecouchaliseinzhomenorissonssicomilsoloitfere.qantilotsorissonfineeildemandaunpouduile,silabeneï:etpuisenmistenlabouchedelapuceleasondoit.dontlidemandalenonsonpere.etcelerespondiisnelement.etpuiscomençaacriertotemplorantdejoie.etliperesporceqeceestoitlapremereinevoizqilavoitdesafilleonqesoïemes.lorsselessierentambeduicheoiraspiezdelseinthom.etcilqilaestoientsesbahirenttozdelgrantmiracle.orniavoitnuldenos,fetgallus,qicestechosemescroiecareuvagiusliprestresqiciestassamblezonosenpuetportertesmoingveritablecardevantluifufeteloevreetlemiracleeinsintcomjelevouscontéai.
oruousdiraiunautrepetitmiracleqeieoiconternamiegranttenzaarpageleprestre.qidistqelafemeavicienleconteenuoiaaseintmartinunpouduileenunefioledeuoire:porbeneirlesmaladessicomilestoitcostume.lafioledeuoirreestoitdetelmaniere.qeleestoitlargeparleuentre.siauoitestroittueletloncsicomlespluiseursontencore:sinestoitmiedeltotpleine.detantdunpoiplusqeliestopanzneportast.liprestresarpages,fetgallus,tesmoignoitdisoit.qeluilecrut,sicomilleuit,alabeneiconseintmartinsiqeilalaforspardeseure.etsicomliserianzqilauoitaportelenreportoit,enissoittoutadeslioilessiqetotesauesteureenfumollie.etqantilparuintasadame,illibaillalafioletresqensomtotepleinesiqeliprestrescuiellefubaillieagarderletesmoigneroitdiroitencore.etausintgrantmeruellefucedontilmesouientencorecarqantliuaisseausdeuoirretozpleinsdeluileqeseinsmartinsauoitbeneiefumisenunefenestreporgarderunsserianzqinelisouintmiegietaundrapdeseureqilafioleabatisorlepauem̅t.qantcilqilaestoientleuirent,ilfurenttuitesbahiporceqilcremirentqelioilesqibeneoisestoitnefustperizsiicorurenttuitensamble:qantiliuindrentiltrouerentlafioletoteentiereaussicomeellefustcheuesormolesplumes.etcestechosenedoitmieestremiseseurlauenturedelcheoirmesalauertudelseinthomecuibeneiconsnepotperir	orvousdiraiunautrepetitmiracleqejeoïconternamiegranttenzaarpageleprestre.qidistqelafemeavicienleconteenvoiaaseintmartinunpouduileenunefioledevoire:porbeneïrlesmaladessicomilestoitcostume.lafioledevoirreestoitdetelmaniere.qeleestoitlargeparleventre.etsiavoitestroittueletetloncsicomlespluiseursontencore:etsinestoitmiedeltotpleine.detantetdunpoiplusqeliestopanzneportast.liprestresarpages,fetgallus,tesmoignoitetdisoit.qeluilecrut,sicomillevit,alabeneïçonseintmartinsiqeilalaforspardeseure.etsicomliserjanzqilavoitaportélenreportoit,enissoittoutadéslioilessiqetotesavesteüreenfumollie.etqantilparvintasadame,illibaillalafioletresqensomtotepleinesiqeliprestrescuiellefubaillieagarderletesmoigneroitetdiroitencore.etausintgrantmervellefucedontilmesovientencorecarqantlivaisseausdevoirretozpleinsdeluileqeseinsmartinsavoitbeneïefumisenunefenestreporgarderunsserjanzqinelisovintmiegietaundrapdeseureqilafioleabatisorlepavement.qantcilqilaestoientlevirent,ilfurenttuitesbahiporceqilcremirentqelioilesqibeneoïsestoitnefustperizsiicorurenttuitensamble:etqantilivindrentiltroverentlafioletoteentiereaussicomeellefustcheüesormolesplumes.etcestechosenedoitmieestremiseseurlaventuredelcheoirmesalavertudelseinthomecuibeneïçonsnepotperir
etqeuoscontereiece.qeꝑsonseintismenonfistcelui.quilatieuscidedenzcuinonienediraimiequillemadesfendu.lafusaturninesliprestresqibienletesmoigneroitencores.oroezetieuousdirai.	etqevosconteréjece.qeparsonseintismenonfistcelui.quilatieuscidedenzcuinonjenediraimiequillemadesfendu.etlafusaturninesliprestresqibienletesmoigneroitencores.oroezetjevousdirai.
ilauintqenosalionsuniorensamblesinoscorutunschiensseureqimoltestoitangoisseusdabaierengres.cilqeieuosdidistauchienjetecomantelnonseintmartinqetutetaises.tantostarrestalauoisdelchienensongauionqelenepotauantissir:siamuientelmaniereqeuoscuidissiezqileustlalanguetrenchie.deceqeieuosdimecreezaussiqepluiseursautresontmeintesbelesmiraclesueuesparceqilapeloientlesuenseintismenon.	ilavintqenosalionsunjorensamblesinoscorutunschiensseureqimoltestoitangoisseusdabaieretengrés.cilqejevosdidistauchienjetecomantelnonseintmartinqetutetaises.tantostarrestalavoisdelchienensongavionqelenepotavantissir:etsiamuientelmaniereqevoscuidissiezqileüstlalanguetrenchie.deceqejevosdimecreezaussiqepluiseursautresontmeintesbelesmiraclesveüesparceqilapeloientlesuenseintismenon.
uneautrefoizauintqauicienslicuensqimoltestoitcruielssicomuosauezoiconterdiresenalasorceusdelacitedetorssiempristpluiseursqilcomandaaenchaeneradestruirepardiuersespeineslendemeinauoitdeuiseqildestruiroitlesautres.qantcestechosefunoncieaseintmartinilsenalatozseusunpoueinzmienuitdeuantlamessondelcruelprincemesilnetrouamieqilesportesliouristporceqetuitdormoient:ilsecouchaaorissonsdeuantlentree.adoncdormoitauiciensmoltfermement:liangelesnostresignorlidistenauisionlisersdiugistataportetutereposeslorssaillisusauicienstozestordizsiapelasesserianzahautesuoizsilordistqildesfermassentlesportesisnielementcarseinzmartinsiestoit.nenesoffrissentmieqeliserianzdeuieustplusnetrauailnepaine.etcilsaillirentsusfirentceqepluiseursdesserianzfontencorescarildespirentleꝯmandementdelorsignor:sidistrentqeceqillorauoitcomandeestoittozsonges:qenusneporroitcelehoreueillierneneseroitalaporte.neneporroientcroireqenuseuesqesfustadontaautruiporte.endementieressendormiauiciensmespetitifureposezqantilresaillisus,siꝯmencaacrier.quemartinsestoitdeuantsaporte.porcenepooitilauoirreposdesoncorsnedesoncorage.siseriantsatargierent,sicomlipluiseurferoientencoreqipereceussont.licuenssaillisussisencoruttresqasdeforeinesporteᷤ.latrouailleseinthomegissantsicomilauoitueuenauision.lichetiscuensfutozesbahizporlademostrancedesigrantuertusidist:sire,porqoiestuuenuzamoiilnetecouientparlerdenulechoseiesaibienqetuquiersdemandes.departtoidemoiqedexnesecorroceamoiportoisisacesbienqeiaiestemolttraueilliezporceqeiecauenisse.etlorssedepartiliseinzhomdela:licuensapelasesserianzsilordistꝯmandaqeillessassentalercuitestozlesprissons.apressedeꝑtiildela,sitintsauoie.dontfutotelacitezmoutesleecieqantelefudeliureedauicienqitantlestraueilloit.destruisoit.etceontoipluiseurshomesreconterdireaauicien.etcemeismesoidirerefrigeriusliprestres:cuiuozueezdeuantuosaunmlt̉prodomeqiagariduzestoitapelezqimeintesfoizliiura,siꝯmerefrigeriusmeismes,leraconteqemeesmementauiciensleracontamoltsouentdistsicomilliestoitauenuetbiensachiesqeieuoelqeuosneuosesmerueilliezmiedeceqeienefishierceqeieuosfazhui.ceestqeieatraipreudomesatesmoingdechascuneuertuqeieiconte.senussemescreoit,siloruoistdemandercarilsontencoreenuie.cecouiētilfeireacelsqisontmalcreable.parlerꝑtesmoinsqileschosesaientueues.orprengenttesmoinzhetiezuiuanzcilqiledotentsilescroient,siluoelent.jemesmerueillecomentnushomdereligionqipointadesensenluipuetcuidier:qenusmentedeseintmartin.ieproiadeuquecestesouspeconcestepenseesedepartiedetozceusqidesozdeuuiuentcarseinzmartinsnanulebesoigneqenuslenessaucenemeteauantparmencoignes.cesacedexqenosnauonsditneneuolonsdirenulechoseqenosnaionsueu:ouqenosnaionsnosmeimesoipleinementconterouautrespreudomesqiencoreletesmoigneroiēt.	uneautrefoizavintqavicienslicuensqimoltestoitcruielssicomvosavezoïconteretdiresenalasorceusdelacitédetorssiempristpluiseursqilcomandaaenchaeneretadestruirepardiversespeinesetlendemeinavoitdeviséqildestruiroitlesautres.qantcestechosefunoncieaseintmartinilsenalatozseusunpoueinzmienuitdevantlamessondelcruelprincemesilnetrovamieqilesportesliovristporceqetuitdormoient:etilsecouchaaorissonsdevantlentree.adoncdormoitaviciensmoltfermement:etliangelesnostresignorlidistenavisionlisersdiugistataporteettutereposeslorssaillisusavicienstozestordizsiapelasesserjanzahautesvoizetsilordistqildesfermassentlesportesisnielementcarseinzmartinsiestoit.nenesoffrissentmieqeliserjanzdeuieüstplusnetravailnepaine.etcilsaillirentsusetfirentceqepluiseursdesserjanzfontencorescarildespirentleconmandementdelorsignor:etsidistrentqeceqilloravoitcomandéestoittozsonges:etqenusneporroitcelehoreveillierneneseroitalaporte.neneporroientcroireqenusevesqesfustadontaautruiporte.etendementieressendormiaviciensmespetitifureposezqantilresaillisus,siconmençaacrier.quemartinsestoitdevantsaporte.etporcenepooitilavoirreposdesoncorsnedesoncorage.siserjantsatargierent,sicomlipluiseurferoientencoreqipereceussont.etlicuenssaillisussisencoruttresqasdeforeinesportes.latrovailleseinthomegissantsicomilavoitveüenavision.lichetiscuensfutozesbahizporlademostrancedesigrantvertusidist:sire,porqoiestuvenuzamoiilnetecovientparlerdenulechosejesaibienqetuquiersetdemandes.departtoidemoiqedexnesecorroceamoiportoietsisacesbienqejaiestémolttraveilliezporceqejeçavenisse.etlorssedepartiliseinzhomdela:etlicuensapelasesserjanzetsilordistetconmandaqeillessassentalercuitestozlesprissons.etapréssedepartiildela,sitintsavoie.dontfutotelacitezmoutesleecieqantelefudelivreedavicienqitantlestraveilloit.etdestruisoit.etceontoïpluiseurshomesreconteretdireaavicien.etcemeïsmesoïdirerefrigeriusliprestres:cuivozveezdevantvosaunmoutprodomeqiagariduzestoitapelezqimeintesfoizlijura,siconmerefrigeriusmeïsmes,leraconteqemeesmementaviciensleracontamoltsoventetdistsicomilliestoitavenuetbiensachiésqejevoelqevosnevosesmerveilliezmiedeceqejenefishierceqejevosfazhui.ceestqejeatraipreudomesatesmoingdechascunevertuqejeiconté.etsenussemescreoit,silorvoistdemandercarilsontencoreenvie.cecovientilfeireacelsqisontmalcreable.parlerpartesmoinsqileschosesaientveües.orprengenttesmoinzhetiezetvivanzcilqiledotentsilescroient,silvoelent.jemesmerveillecomentnushomdereligionqipointadesensenluipuetcuidier:qenusmentedeseintmartin.jeproiadeuquecestesouspeçonetcestepenseesedepartiedetozceusqidesozdeuviventcarseinzmartinsnanulebesoigneqenuslenessaucenemeteavantparmençoignes.etcesacedexqenosnavonsditnenevolonsdirenulechoseqenosnaionsveü:ouqenosnaionsnosmeïmesoïpleinementconterouautrespreudomesqiencoreletesmoigneroient.
saceaillesonmostierousimoineestoi--ent:estoit.ii.liuesensusdelacite.ettouteslesheuresqilmetoitlepieforsdesacelleporaleraleglissetuitcilqiforsdelsensestoientenleglisseꝯmencierentafremiradesuer.sitrambloientaussintdepoorcomseloriusticeuenistsiqeliclercdeleglissesauoientbienparlescrizdeceusqiforsdelsenzestoient:qeseinzmartinsliarcheuesqesuenoit.etiemeismesuicundeceusquilideablestraueilloit.entelemaniereqeqantseinzmartinsaproismadeleglise,qecilfuleuezenhautenlair.sitenoitsesbrazestenduzaussicomsilfustpenduzparlespaumes.sinauoitpassespiezaterre.adoncuintseinzmartinsuestuzdesaheireesparzsonchiefdecendres,sifistfermerleshuissisecouchaenorissōsenmileglisse.dontueissiezleschetisdestreīspardolereusespainesporcequelideablenesenpooientfoirqiescorslorestoient.liunipendoientenhautparlespiezaussicomsiluenissentdeuerslesnues.porcenestoientilmiedescouerzdeloruesteures,qeladaerreinepartiedelorcorsnefeistuergoigneaceusqienleglisseestoient.dontsiueissiezdautrepartlesautrestraueilliezdeceqilregehissoientlorhontessanzceqenlordemandast.sidisoientlornonsparqoiilestoientapelez.liunsdisoitqilauoitnoniupiter:liautresmercurius.audaerreinfurentilmouttormentebatuparleseīthomechaciedeleglisseforsdescorsdeshomesouilestoient.etparceregehissonsnosquenseintmartinfuaemplicontrueueenlescritureqidistqeliseinthomeueinterontlesangeles.apresceuosconteraidunautremiracle.	saceailleetsonmostierousimoineestoi--ent:estoit.ii.liuesensusdelacité.ettouteslesheuresqilmetoitlepiéforsdesacelleporaleraleglissetuitcilqiforsdelsensestoientenleglisseconmencierentafremiretadesver.etsitrambloientaussintdepoorcomselorjusticevenistsiqeliclercdeleglissesavoientbienparlescrizdeceusqiforsdelsenzestoient:qeseinzmartinsliarchevesqesvenoit.etjemeïsmesviçundeceusquilideablestraveilloit.entelemaniereqeqantseinzmartinsaproismadeleglise,qecilfulevezenhautenlair.etsitenoitsesbrazestenduzaussicomsilfustpenduzparlespaumes.etsinavoitpassespiezaterre.adoncvintseinzmartinsvestuzdesaheireetesparzsonchiefdecendres,sifistfermerleshuissisecouchaenorissonsenmileglisse.dontveïssiezleschetisdestreinspardolereusespainesporcequelideablenesenpooientfoïrqiescorslorestoient.liunipendoientenhautparlespiezaussicomsilvenissentdeverslesnues.etporcenestoientilmiedescoverzdelorvesteüres,qeladaerreinepartiedelorcorsnefeïstvergoigneaceusqienleglisseestoient.dontsiveïssiezdautrepartlesautrestraveilliezdeceqilregehissoientlorhontessanzceqenlordemandast.etsidisoientlornonsparqoiilestoientapelez.liunsdisoitqilavoitnonjupiter:etliautresmercurius.audaerreinfurentilmouttormentéetbatuparleseinthomeetchaciédeleglisseetforsdescorsdeshomesouilestoient.etparceregehissonsnosquenseintmartinfuaemplicontrueveenlescritureqidistqeliseinthomeveinterontlesangeles.apréscevosconteraidunautremiracle.
enlaterredesenzauoituneuile.ougresiuztempestegastoitchascunanlesblezlesauainestozlesfruisdesterres.tantqelilaboureordesterrescesontliahanierqisoffertenauoientmeinsmausmeintespainestrestrentaseintmartin.siliproierentdemanderentaide.liseinzhomuintenunchampqelatempestesoloitplusdegasterqetouzlesautressifistsorissonetqantillotfetediteanostresignorilotsideliureetoutelacontreedelagranttempeste.qeonquesen.xx.anzqiluesquiapresnicheitempesteneoragesnegresiuznifuueuzparnulhome.etporcequelencuidastqecestdonnefustdonezparseintmartindedenzlanqilmorutreuintenzelpaislatempestedesgresiuzsicomilsoloientestre.dontsesentirentcildelpaisdeldeꝑtementseintmartin.siploroientdelamortdeluiaussintcomilsesleecassentdesauie.etsenusnosde.mandoittesmoinsdeceschosesprouerqenosauonsdites,sachebienqeienelenamenroiemieunhometantseulementmesmoutdemillierscartuitcilqidelaregiondesenzqibienesprouerentlagrantuertulemiracleletesmoigneroiēt.meesmementrefrigeriusliprestresqiesticienpresenceletesmoigneroitsicomcilqilameintesfoizoiconterdireaceusqiifurent:cilqilenoscontoitenplorameinteslarmesporlamordelseinthomecarilauoitgrantdomagedelfruitdesaterreparlatempesteqireuenueestoitsicomieuosaiconte.	enlaterredesenzavoitunevile.ougresiuzettempestegastoitchascunanlesblezetlesavainesettozlesfruisdesterres.ettantqelilaboureordesterrescesontliahanierqisoffertenavoientmeinsmausetmeintespainestrestrentaseintmartin.etsiliproierentetdemanderentaïde.etliseinzhomvintenunchampqelatempestesoloitplusdegasterqetouzlesautressifistsorissonetqantillotfeteetditeanostresignorilotsidelivreetoutelacontreedelagranttempeste.qeonquesen.xx.anzqilvesquiaprésnicheïtempesteneoragesnegresiuznifuveüzparnulhome.etporcequelencuidastqecestdonnefustdonezparseintmartindedenzlanqilmorutrevintenzelpaïslatempestedesgresiuzsicomilsoloientestre.dontsesentirentcildelpaïsdeldepartementseintmartin.etsiploroientdelamortdeluiaussintcomilsesleeçassentdesavie.etsenusnosde.mandoittesmoinsdeceschosesproverqenosavonsdites,sachebienqejenelenamenroiemieunhometantseulementmesmoutdemillierscartuitcilqidelaregiondesenzqibienesproverentlagrantvertuetlemiracleletesmoigneroient.etmeesmementrefrigeriusliprestresqiesticienpresenceletesmoigneroitsicomcilqilameintesfoizoïconteretdireaceusqiifurent:etcilqilenoscontoitenplorameinteslarmesporlamordelseinthomecarilavoitgrantdomagedelfruitdesaterreparlatempesteqirevenueestoitsicomjevosaiconté.
oruosreuendraiaauicienlecontedontieuosaideuantcontedit.qisacruiautenauoitencoremieperdueeinzlademenoitmoltgrantentozlesleuspartoteslescitesdelaꝯtree.forstantsolementenlacitedetors.orpoezuozsauoirqeceestoitgranzuertuzdelseinthomeqecilestoitsicruielzatoutecreature.auoitdeuantluitotesacruiauteperdue.uniorauintqeseinzmartinsalaaluiparlersientradedenzsaporteconqesnelifuadondesfendue.alatātqilletrouaseantensachambre.ettantostcomilentraenlachambreuitilderriereledosauiciendroitserrantasesespaulesundeableseoir.qiestoitdetropmerueilleusegrandeur.qantseinzmartinsuintdeloingillesofflaaussiunpetitcomsilparlastalui.dontcuidaauiciensqecefustaluisidist:seinzhom,qemeregardestuseinzmartinslirespondi:cenestmieatoimesaceluiqiestapoiezatesespaules.dontsendepartilienemismoltdolēzsideguerpileleuouilestoitqeilniosaplusdemorer.ettresceiorenauantsotlenbien.qeauiciensfuplusdouzplusdeboneireqeonqesnauoitestedeuantsinesaisecefuporceqilsotentendibiēqilauoitfetelauolenteaudeableqitoztensestoitensambleolui.ousecefuporceqelideablesauoitperduesapoestedeluiensignierparceqeseinzmartinslenauoitchaciemisarriere.	orvosrevendraiaavicienlecontedontjevosaidevantcontéetdit.qisacruiauténavoitencoremieperdueeinzlademenoitmoltgrantentozlesleusetpartoteslescitésdelacontree.forstantsolementenlacitédetors.orpoezvozsavoirqeceestoitgranzvertuzdelseinthomeqecilestoitsicruielzatoutecreature.etavoitdevantluitotesacruiautéperdue.unjoravintqeseinzmartinsalaaluiparlersientradedenzsaporteconqesnelifuadondesfendue.etalatantqilletrovaseantensachambre.ettantostcomilentraenlachambrevitilderriereledosaviciendroitserrantasesespaulesundeableseoir.qiestoitdetropmerveilleusegrandeur.qantseinzmartinsvintdeloingillesofflaaussiunpetitcomsilparlastalui.dontcuidaaviciensqecefustaluisidist:seinzhom,qemeregardestuseinzmartinslirespondi:cenestmieatoimesaceluiqiestapoiezatesespaules.dontsendepartilienemismoltdolenzetsideguerpileleuouilestoitqeilniosaplusdemorer.ettrescejorenavantsotlenbien.qeaviciensfuplusdouzetplusdeboneireqeonqesnavoitestédevantsinesaisecefuporceqilsotetentendibienqilavoitfetelavolentéaudeableqitoztensestoitensambleolui.ousecefuporceqelideablesavoitperduesapoestédeluiensignierparceqeseinzmartinslenavoitchaciéetmisarriere.
elchasteldembaiseauoituneydregrant.merueilleuse.dontieuosconterailauenturelipaienqilauoientfaiteauoientfaitdebelespierrespoliesunmurhautespesmassisaguissedetor:ladeseureauoientestabliuntrosneouceleẏdreestoitmiseaoreemesliseinzhomlenauoitiaabatuelisiegeslatoriestoitremesseseinzmartinsmandameintesfoizamarcelqidontestoitprestresdecelleu.qildestruisistceletorabatistporcequeencoreiauoientfiancecil.qiencoreadoncnestoientmieatorneauraiecreanceliprestresnenfistnoientporceqilnauoitpooirdelabatre.aprescepetitdetensreuītseinzmartinsauchastelsiblasmamoutleprestre.deceqelisiegesdelẏdreestoitencoreenestant.cilrespondiqeapeinesseroitilabatuzportozceusdelauileetꝯmentleporroientildontabatreparmoinesqienfermeestoient.neparclersqigueresnauoientdepuissancedontfuseinzmartinsenorissonstotelenuitenueilles.qantuintlamatinee,unetempesteleuasigrantsioribleunefoudrequilabatirentlemesondelẏdrelesforsm̃stresqeelfondement.etcetesmoignemarceausliprestresqiuitlachosesicomielauousaiconteediteapresceuouscontereiieunautremiracle.qinestmiegranmentdessamblablesacestui:siletesmoignerarefrigeriusliprestresqiciestempresent.	elchasteldembaiseavoituneydregrant.etmerveilleuse.dontjevosconterailaventurelipaienqilavoientfaiteavoientfaitdebelespierrespoliesunmurhautetespésetmassisaguissedetor:etladeseureavoientestabliuntrosneouceleydreestoitmiseetaoreemesliseinzhomlenavoitjaabatueetlisiegesetlatoriestoitremesseseinzmartinsmandameintesfoizamarcelqidontestoitprestresdecelleu.qildestruisistceletoretabatistporcequeencoreiavoientfiancecil.qiencoreadoncnestoientmieatornéavraiecreanceliprestresnenfistnoientporceqilnavoitpooirdelabatre.apréscepetitdetensrevintseinzmartinsauchastelsiblasmamoutleprestre.deceqelisiegesdelydreestoitencoreenestant.cilrespondiqeapeinesseroitilabatuzportozceusdelavileetconmentleporroientildontabatreparmoinesqienferméestoient.neparclersqigueresnavoientdepuissancedontfuseinzmartinsenorissonstotelenuitetenveilles.qantvintlamatinee,unetempestelevasigrantetsioribleetunefoudrequilabatirentlemesondelydreetlesforsmurstresqeelfondement.etcetesmoignemarceausliprestresqivitlachosesicomjelavousaiconteeetditeapréscevouscontereijeunautremiracle.qinestmiegranmentdessamblablesacestui:etsiletesmoignerarefrigeriusliprestresqiciestempresent.
unecoulombeotmouthautemoltgrantenunchastel.deseurecelecolombesiauoitunẏdre.ceestuneẏmagedesarrazinzouilauoientgrantfiance.qantseinzmartinslapercutuitilsepensacomentilleporroitabatremesnepotueoirengiencỏmentellefustabatue.qantiluitce,ilsecouchaenorisonssicomesacostumeestoit.tantostcomilotdefineesorissonunecolombegrantmerueilleuseuintdeuerslecieltrebuchantseurcelemeismecolombeseurlẏmagesiqelelabatidebrisatrestoteenpoudre.etceuirentcilqilaestoientfetgallus,refrigeriusliprestresqicimescouteentent.	unecoulombeotmouthauteetmoltgrantenunchastel.etdeseurecelecolombesiavoitunydre.ceestuneymagedesarrazinzouilavoientgrantfiance.qantseinzmartinslaperçutetvitilsepensacomentilleporroitabatremesnepotveoirengienconmentellefustabatue.qantilvitce,ilsecouchaenorisonssicomesacostumeestoit.tantostcomilotdefineesorissonunecolombegrantetmerveilleusevintdeverslecieltrebuchantseurcelemeïsmecolombeetseurlymagesiqelelabatietdebrisatrestoteenpoudre.etcevirentcilqilaestoientfetgallus,etrefrigeriusliprestresqicimescouteetentent.
uneautrefoizauintqenosestionssorlariueduneeue.unsserpenzuintdescendantdunerochesisemistenleuepornostrespasserdautrepartlariueounosestions.qantseinzmartinslauitueniriltendisamainuerslui,silidistjetecoumancelnonnostresignorqetutenrepairesarriere.tantostretornaliserpenzalaparoledelseinthome:sireuintalariuedontilestoituenuzsiqenosleueismes.sicomnosesgardionscestmiracleliseinzhomꝯmencamolthautagemirsidistliserpentmoiententendent.lihomenemeuoelententend.neoir.	uneautrefoizavintqenosestionssorlariveduneeve.etunsserpenzvintdescendantdunerochesisemistenlevepornostrespasserdautrepartlariveounosestions.qantseinzmartinslavitveniriltendisamainverslui,silidistjetecoumançelnonnostresignorqetutenrepairesarriere.tantostretornaliserpenzalaparoledelseinthome:etsirevintalarivedontilestoitvenuzsiqenosleveïsmes.sicomnosesgardionscestmiracleliseinzhomconmençamolthautagemiretsidistliserpentmoientetentendent.etlihomenemevoelententendre.neoïr.
apresauintuneautrefoizparunsiorzpasqueresqueliseinzhomdemandaaceluiqileseruoit.silauroitpointdepoissoncaresiorzdepassmengoitilpoissonparcostumeparles.iiii.iorztantsolementbiensachiezqilenmengoitmoltpetit.dontrespondicilqilnenauoitnulpriscarilmeismessauoitpeschier.siestoitdẏacressiauoitnonchatons.neentoutleiornenpotilnultrouerauendre.qantliseinzhomloiparlerillirespondisidistoruasimettaroizenleuetuprenderasaucunechose.dontsenalaliserianzsifistsicomliseinzhomliauoitditetnosalamesapresporueoirlauenturecarlihabitaclesestoitpresdeleue.cilmistlaroizenleuesipristaupremereintretungrantpoissonsisenrepeiramoltliezalabeie,silemostraaseintmartinqianostresignorenrendigracesloenges.orpoezuosueoirqecisseinzhommostramoltbelexempleapluisorsgenz.parlesgranzuertuzqenostresiresdemostroitporluiqilegloirefioitdediuersesgracesqienluiestoientdepluisorsmiracles.	aprésavintuneautrefoizparunsjorzpasqueresqueliseinzhomdemandaaceluiqileservoit.silauroitpointdepoissoncaresjorzdepasqesmengoitilpoissonparcostumeparles.iiii.jorztantsolementetbiensachiezqilenmengoitmoltpetit.dontrespondicilqilnenavoitnulpriscarilmeïsmessavoitpeschier.etsiestoitdyacresetsiavoitnonchatons.neentoutlejornenpotilnultroveravendre.qantliseinzhomloïparlerillirespondietsidistorvaetsimettaroizenlevetuprenderasaucunechose.dontsenalaliserjanzsifistsicomliseinzhomliavoitditetnosalamesaprésporveoirlaventurecarlihabitaclesestoitpresdeleve.cilmistlaroizenlevesipristaupremereintretungrantpoissonsisenrepeiramoltliezalabeïe,silemostraaseintmartinqianostresignorenrendigracesetloenges.orpoezvosveoirqecisseinzhommostramoltbelexempleapluisorsgenz.parlesgranzvertuzqenostresiresdemostroitporluiqilegloirefioitdediversesgracesqienluiestoientdepluisorsmiracles.
arboriusmeesmementtesmoigne:qeiluitmeintesfoiz,celisambla,qe,laouilestoitiosteleseinthome,qantilestoitapareilliezalautel,qesesmeinsresplendissoientaussintcomeprecieusesgemmes.laouillesatouchoit,qillisambloitqilauoitsouentesfoizoileresonementdespierresprecieuses.etcestechoseentesmoignearboriusqiciestenpresentmesoruendraiaceqilcelatantcomilpotatotesgenz,mesanosnelepotilcelerqidesacompaignieestions.etenceqeieuosuoelconterporrezuossauoirentendreqeliangelenostresignorparlaaluifaceaface.meismesliempereresderome:fistenceltenzẏtaceeuesqedetrieuesapreslamortpriscillienqieuesqesenauoiteste.etcilẏtacessicompaignondontilnestencoredelnomerbesoing:auoienttoziorzesteencontrepriscilliencuilenauoittenuaseinthomemestoztensestoienttenualempereor:meintenuparlui.entrecezchosesuintseinzmartinsatrieues:laestoientpluseurseuesqesassamblezquiensambleẏstacesetenoient.tantostcỏlanouelefuaeusuenueqeseinzmartinsuenoitilfurentmoltespoentez.sitramblerentdepoordelseinthome.leiordeuantauoitliempereresdeuiseparlessentencesdeseuesqes:qilenuoieroitsespreuozseshomestozarmezenlaterredespaigneqipartoutprenderoientles.qnͣtillesauroientpris,silortoudroientlesauoirslesuies.ornestilmiegrantdou--tanceqegranztorbesdeseinzhomesnefussentdegasteesparcelafaireentrelamanieredepluiseursautresgenzcaraseuzesgardoienttantsolementcilqilesqeroientassemblances.etlaouilueoientlesuesteuresceusqiempaliestoientsicuidoientqilfussentmielzqefermementcreable.cestechosesauoientbienlieuesqqilaestoientassembleqeaseintmartinnepleiroitmie:porcesienestoientildolenzqilnesetenistmieacelproposement.qilauoitproposeafere.deceaussiquilnensiuissentmielesoeuresqeliseinzuolsistqilalassentsoloncdroitureparlauictoiredeceluiqienluiestoitporcez.ii.chosesdontilauoientdoutealerentilalempereorsilidistrent.qilenuoiastencontreseintmartin:silideffendistqilnaproismastlacitesilneuoloitestrealapesalaconcordancedeseuesqesqiiluecestoientassemblez.qantliseinzhomloiilfudeceuzparuoisdiesiregehidistqeparpesiuoudroitiluenir.apressientraenlaciteparnuitsisenalaaleglisseporsesorissonsfeire.autierziorapressenalaalpalez.entremolteschosesqilauoitafeirealempereorarequerreestoitsententionsouraineqecilnefussentmieenuoiezenespaigneqialerideuoient.piteuseententionestoitauseinthomedecemeismementqilneuoloitmieqelicrestienfussentdeliureparsaproieretantsolementmesliheriteaussintmesliuoiseusempereresqiuoloitqilnereqeistmiecestechosenomeementlessospendiceestqillefistaluiparlerdeslepremieriorentendrelesecontqilleuenoitrerreqeonqesneuoutaluiparler:cefuporceqiluoloitqilensiuistlesautresquiduneconcordanceestoient.ouporceqeliseinzhomliestoitdurscruielsparparoles.ouporceqeliempereresbaoitaauaricecariluoloitauoirdelordelargentdesmalueshomesqienuersluiserachatassentaussicomepluseursferoientencore.qiparlorgrantcouoitisse.dōtilsontesprisadeuisefonttieuschosesqillesseroientseilloeureseintmartincreoient.mescesacenttuitqeauiugement.ouchascunssonloieratentlanauranulmauuesloiercardexlorferadroitplen̉.etacebaoitmausimesliempereres.neqedentnestoitilmieencelafairemlt̉couoiteuseinzlefaisoitporlabesoignedesonregne.parcesencuidoitilescuserseilauoirenpreistcarilauoittotsontresordespendu.lauoirdeseshomesenpluiseursbatailles.entrecezchosesralerentlieuesqealempereorpargrantpoor.secompleinstrentaluidistrent.qilestoientdampnes,seseinzmartinsestoitdeuerstheonisteqitozseuslesblasmoitapertement.telhomenedeuroitlenmierecoiurededenzlesmursqilachoseporroitfaireamaltorneracestafaire:sidistrentencoreqelamorsdepriscillienqiencontreeusestoitneualoitnuleriensemartinssepenoitdeluiuengier.qantilorenttotceditalempereorillicheirentaspiez.siliproierenttotemplorantqiliurastouurastsaforceencontreleseinthomemesbiensaciezqilnelapieloientmieseinthomeeinzdisoientqeliempereresesprouastsaforceencontreunseulhome.dontfaillimoutpouqeliempereresnefuacemenezparlesmaluezeuesqesqeseinzmartinsnefustdampnez:ensambleolesherites.mesencorefustildeuersleseuesqesilsauoitbienqeseinzmartinsestoitdegrantfoi.degrantseinteedegrantuertuenuerstotehumeinenaturesiseporpensaportoteschoses.qilleueinteroitparautremaniereqeparforce,silpooitsiqilseroitalacortdeseuesqes.donttrestliempereresaseintmartin:silidist﻿ꝑmoutbelesparoles:condeuoitbiēlesheritesdampnerpardroit.qetheonistesauoitplusensiuilamalueseloiqenusautresmeslessasttotesceschosessisetenistalacomunite.alacompaigniedeseuesqes.qantseinzmartinsoiensiparlerlemꝑeorriensnelifudequanqildisoit.neporceneseuoloitilmiemetrealacortdeseuesqesqillessauoitfelonsdemaluesemaniere.adoncsepartiliempereresmoltcorrociezdeluisiꝯmandaasesserianzasespreuozqilalassenttozcelsocirredontseinzmartinsliauoitproiecarilleuoloitcorrocierporceqilneuoloitriēsfaireporlui.qantseinzmartinssotcestechoseilestoitianuiztotenoire.aceleheuresenaladroitementaupaleslempereor:selidistqeseillecomandementqilauoitfetdelessoitsiqecilsenrepairassentqienespaignesenaloientporleseglissesdestruireilferoitceqilliprioit.qantmaximiensliemꝑeresloi,illotroiauolentiers.sipardonasonmautalentaceusqiluoloitdestruire.autierziorapresfuordenezaeuesqefelicesqifumoltseinzhompreudỏ.enlacompaigniedesautresalaceiorseinzmartinsporceqemielzlisemblaceafereqecelslessierocirreqeliempereresauoitcomandeadestruire.	arboriusmeesmementtesmoigne:qeilvitmeintesfoiz,celisambla,qe,laouilestoitjosteleseinthome,qantilestoitapareilliezalautel,qesesmeinsresplendissoientaussintcomeprecieusesgemmes.etlaouillesatouchoit,qillisambloitqilavoitsoventesfoizoïleresonementdespierresprecieuses.etcestechoseentesmoignearboriusqiciestenpresentmesorvendraiaceqilcelatantcomilpotatotesgenz,mesanosnelepotilcelerqidesacompaignieestions.etenceqejevosvoelconterporrezvossavoiretentendreqeliangelenostresignorparlaaluifaceaface.meïsmesliempereresderome:fistenceltenzytaceevesqedetrievesapréslamortpriscillienqievesqesenavoitesté.etcilytacesetsicompaignondontilnestencoredelnomerbesoing:avoienttozjorzestéencontrepriscilliencuilenavoittenuaseinthomemestoztensestoienttenualempereor:etmeintenuparlui.entrecezchosesvintseinzmartinsatrieves:etlaestoientpluseursevesqesassamblezquiensambleystacesetenoient.tantostcomlanovelefuaeusvenueqeseinzmartinsvenoitilfurentmoltespoentez.etsitramblerentdepoordelseinthome.lejordevantavoitliempereresdeviséparlessentencesdesevesqes:qilenvoieroitsesprevozetseshomestozarmezenlaterredespaigneqipartoutprenderoientles.etqantillesauroientpris,silortoudroientlesavoirsetlesvies.ornestilmiegrantdou--tanceqegranztorbesdeseinzhomesnefussentdegasteesparcelafaireentrelamanieredepluiseursautresgenzcaraseuzesgardoienttantsolementcilqilesqeroientetassemblances.etlaouilveoientlesvesteüresetceusqiempaliestoientsicuidoientqilfussentmielzqefermementcreable.cestechosesavoientbienlievesqueqilaestoientassembléqeaseintmartinnepleiroitmie:etporcesienestoientildolenzqilnesetenistmieacelproposement.qilavoitproposéafere.etdeceaussiquilnensivissentmielesoevresqeliseinzvolsistqilalassentsoloncdroitureparlavictoiredeceluiqienluiestoitporcez.ii.chosesdontilavoientdoutealerentilalempereorsilidistrent.qilenvoiastencontreseintmartin:etsilideffendistqilnaproismastlacitésilnevoloitestrealapesetalaconcordancedesevesqesqiiluecestoientassemblez.qantliseinzhomloïilfudeceüzparvoisdieetsiregehietdistqeparpesivoudroitilvenir.apréssientraenlacitéparnuitsisenalaaleglisseporsesorissonsfeire.autierzjorapréssenalaalpalez.etentremolteschosesqilavoitafeirealempereoretarequerreestoitsententionsovraineqecilnefussentmieenvoiezenespaigneqialeridevoient.piteuseententionestoitauseinthomedecemeïsmementqilnevoloitmieqelicrestienfussentdelivréparsaproieretantsolementmesliheriteaussintmeslivoiseusempereresqivoloitqilnereqeïstmiecestechosenomeementlessospendiceestqillefistaluiparlerdéslepremierjoretentendreetlesecontqillevenoitreqerreqeonqesnevoutaluiparler:etcefuporceqilvoloitqilensivistlesautresquiduneconcordanceestoient.ouporceqeliseinzhomliestoitdursetcruielsparparoles.ouporceqeliempereresbaoitaavaricecarilvoloitavoirdeloretdelargentdesmalvéshomesqienversluiserachatassentaussicomepluseursferoientencore.qiparlorgrantcovoitisse.dontilsontesprisadevisefonttieuschosesqillesseroientseilloevreseintmartincreoient.mescesacenttuitqeaujugement.ouchascunssonloieratentlanauranulmauvésloiercardexlorferadroitplenier.etacebaoitmausimesliempereres.etneqedentnestoitilmieencelafairemoutcovoiteuseinzlefaisoitporlabesoignedesonregne.etparcesencuidoitilescuserseilavoirenpreïstcarilavoittotsontresordespendu.etlavoirdeseshomesenpluiseursbatailles.entrecezchosesralerentlievesqealempereorpargrantpoor.etsecompleinstrentaluietdistrent.qilestoientdampnés,seseinzmartinsestoitdeverstheonisteqitozseuslesblasmoitapertement.ettelhomenedevroitlenmiereçoivrededenzlesmursqilachoseporroitfaireamaltorneracestafaire:etsidistrentencoreqelamorsdepriscillienqiencontreeusestoitnevaloitnuleriensemartinssepenoitdeluivengier.qantilorenttotceditalempereorillicheïrentaspiez.etsiliproierenttotemplorantqiljurastetouvrastsaforceencontreleseinthomemesbiensaciezqilnelapieloientmieseinthomeeinzdisoientqeliempereresesprovastsaforceencontreunseulhome.dontfaillimoutpouqeliempereresnefuacemenezparlesmalvezevesqesqeseinzmartinsnefustdampnez:ensambleolesherites.mesencorefustildeverslesevesqesilsavoitbienqeseinzmartinsestoitdegrantfoi.etdegrantseinteéetdegrantvertuenverstotehumeinenaturesiseporpensaportoteschoses.qilleveinteroitparautremaniereqeparforce,silpooitsiqilseroitalacortdesevesqes.donttrestliempereresaseintmartin:etsilidist﻿parmoutbelesparoles:condevoitbienlesheritesdampnerpardroit.etqetheonistesavoitplusensivilamalveseloiqenusautresmeslessasttotesceschosesetsisetenistalacomunité.etalacompaigniedesevesqes.qantseinzmartinsoïensiparlerlempereorriensnelifudequanqildisoit.neporcenesevoloitilmiemetrealacortdesevesqesqillessavoitfelonsetdemalvesemaniere.adoncsepartiliempereresmoltcorrociezdeluisiconmandaasesserjanzetasesprevozqilalassenttozcelsocirredontseinzmartinsliavoitproiécarillevoloitcorrocierporceqilnevoloitriensfaireporlui.qantseinzmartinssotcestechoseilestoitjanuiztotenoire.etaceleheuresenaladroitementaupaléslempereor:etselidistqeseillecomandementqilavoitfetdelessoitsiqecilsenrepairassentqienespaignesenaloientporleseglissesdestruireilferoitceqilliprioit.qantmaximiensliempereresloï,illotroiavolentiers.etsipardonasonmautalentaceusqilvoloitdestruire.autierzjoraprésfuordenezaevesqefelicesqifumoltseinzhometpreudom.enlacompaigniedesautresalacejorseinzmartinsporceqemielzlisemblaceafereqecelslessierocirreqeliempereresavoitcomandéadestruire.
apresceqeeinsioteste,ilsenrepaira:sicomiluintalauoie,sicoumencaaestremoutdolenzdeceqilauoitfetsisenpristmoltacompleīdre.etsicomilestoitassispresdunchastelqiestoitauironezdegranzfores.ilsecomplegnoitpargrantdoleurdicelecompaignieqilauoittenueasmauueseuesqesliangelesnostresignorliuintdeuantsilidistmartin,tudoizbienpardroitauoircestedoleurferemestunetenpeusautrem̅tdelempereorpartir.orreprentauertu:sinetedesespoiremie.lorssepartideluiliangelesilremestauqesreconfortezdesapesance.biensachiez,fetgaulus,qepuisceltensseschiuailtoutadesdelacoumunitedelacompaigniedeseuesqesqiaceleassambleefurent.etencoreauintunior,fetgaullusaceusqilescoutoientqilmistpluslongementqilnesoloitaunderuegarirdeliurerdeldeable.ielioidiretotemplorant:qeparcelecompaignieouilauoitesteparbesoignenonmiedecuer:sentoitilqesauertuzestoitamenuisie.apresceuesquiil.xvi.anz:neonqespuisnalaasenneneaassambleedeuesqesainzsenatinttātcomilpottantcomiluesquipuisdelorcompaignieaussint.mespuisqilfureuenuzalacitedetorsrecourail,siqenueimesbienesprouames,totpleinem̅tsagrantuertusilifudobleecarieuicunderueamenerasabeie.eincoizquiluenistaluisdelmostierneqilentrastdedenz,fuilmondezgueriz.	aprésceqeeinsiotesté,ilsenrepaira:etsicomilvintalavoie,sicoumençaaestremoutdolenzdeceqilavoitfetsisenpristmoltacompleindre.etsicomilestoitassispresdunchastelqiestoitavironezdegranzforés.etilsecomplegnoitpargrantdoleurdicelecompaignieqilavoittenueasmauvésevesqesliangelesnostresignorlivintdevantetsilidistmartin,tudoizbienpardroitavoircestedoleuretferemestunetenpeusautrementdelempereorpartir.orreprentavertu:etsinetedesespoiremie.lorssepartideluiliangelesetilremestauqesreconfortezdesapesance.etbiensachiez,fetgaulus,qepuisceltensseschivailtoutadésdelacoumunitéetdelacompaigniedesevesqesqiaceleassambleefurent.etencoreavintunjor,fetgaullusaceusqilescoutoientqilmistpluslongementqilnesoloitaundervégariretdelivrerdeldeable.jelioïdiretotemplorant:qeparcelecompaignieouilavoitestéparbesoignenonmiedecuer:sentoitilqesavertuzestoitamenuisie.apréscevesquiil.xvi.anz:neonqespuisnalaasenneneaassambleedevesqesainzsenatinttantcomilpotettantcomilvesquipuisetdelorcompaignieaussint.mespuisqilfurevenuzalacitédetorsrecovrail,siqenosveïmesbienetesprovames,totpleinementsagrantvertuetsilifudobleecarjeviçundervéamenerasabeïe.eteinçoizquilvenistaluisdelmostierneqilentrastdedenz,fuilmondezetgueriz.
apresceuicieunhomeqimecontadist:qesicomilpluiseursautresdesescompaignonsnaioientenlamer:ilsenuenoientagranzuoilestenduesunsestorbellonsloruintunegranztempesteqilormastfistploierloruoilesderrompre.leurnefcroistreentelemaniereqilauoienttouteesperanceperduedeuiure.encelenefauoitunmarcheantdegẏptequiencorenestoitmiecrestiens.cilꝯmencaahautesuoizacrieradire:lidexqemartīsaeure,aidenosseqeurdeliuredecestperiltantostfulamerapesielatempestedepartie.cilsenuindrentasauueteauportqildesirroient.	aprésceviçjeunhomeqimecontaetdist:qesicomiletpluiseursautresdesescompaignonsnajoientenlamer:etilsenvenoientagranzvoilestenduesunsestorbellonslorvintetunegranztempesteqilormastfistploieretlorvoilesderrompre.etleurnefcroistreentelemaniereqilavoienttouteesperanceperduedevivre.encelenefavoitunmarcheantdegyptequiencorenestoitmiecrestiens.cilconmençaahautesvoizacrieretadire:lidexqemartinsaeure,aïdenosetseqeuretdelivredecestperiltantostfulamerapesieetlatempestedepartie.etcilsenvindrentasauvetéauportqildesirroient.
uneautrefoizauintqelipuost,unsmoltpreudomuicairesestoitmaximeslemꝑeordegnͣtbailliemandaauseinthomeꝑsesletresmoutdocementqillifeistaidesecors,carsamesnietoteestoitsientreprissedegrātdoleurdegrantmaladieqilgisoienttuitcontrelitsiestoienttuitsientreprisderoignedegrantporretureqilsembloitqilfussenttuitperi.qantseinzmartinsoice,illiremandaqeceseroittropgriefchoseafeirecarilsauoitbienqeparlauolētenostreseignorestoitcelemesnietormentee.nonporqantilsecouchaenorissonsuersnostresignor:sifuengeunes﻿ꝑ.vii.iorzpar.vii.nuiz.enueilles,qenostresiresentendistsaproiere.adontuintliconcelesaluisidistcontaqiltoutesamesnieestoientdeliuredeceltormentouilestoient.dontlifistaportercentliuͤsdargent.etliseinzhomnesrecutneescondieinzsepensaqilenrachateroitleschetis,seilemprisonestoient.donttrestrentaluilifreresilidistrentqilengardastaucunechoselesdespenzdelabeiecarlipluiseurauoientpouuiandes.liaucunpouuesteures.ilrespondisidist:leglissenospesseuestecarnosnequeronsmienenedemandonslesterriensauoirsaoesnosdespenses.	uneautrefoizavintqeliprevost,unsmoltpreudometvicairesestoitmaximeslempereordegrantbailliemandaauseinthomeparsesletresmoutdocementqillifeïstaïdeetsecors,carsamesnietoteestoitsientreprissedegrantdoleuretdegrantmaladieqilgisoienttuitcontrelitetsiestoienttuitsientreprisderoigneetdegrantporretureqilsembloitqilfussenttuitperi.qantseinzmartinsoïce,illiremandaqeceseroittropgriefchoseafeirecarilsavoitbienqeparlavolenténostreseignorestoitcelemesnietormentee.etnonporqantilsecouchaenorissonsversnostresignor:etsifuengeunes﻿par.vii.jorzetpar.vii.nuiz.etenveilles,qenostresiresentendistsaproiere.adontvintliconcelesaluietsidistetcontaqilettoutesamesnieestoientdelivrédeceltormentouilestoient.dontlifistaportercentlivresdargent.etliseinzhomnesreçutneescondieinzsepensaqilenrachateroitleschetis,seilemprisonestoient.donttrestrentaluilifrereetsilidistrentqilengardastaucunechoselesdespenzdelabeïecarlipluiseuravoientpouviandes.etliaucunpouvesteüres.ilrespondietsidist:leglissenospesseetvestecarnosnequeronsmienenedemandonslesterriensavoirsaoésnosdespenses.
einsi	einsi
dist	dist
gallus	gallus
a	a
seuerus	severus
qe	qe
li	li
seinz	seinz
hom	hom
enrespondi	enrespondi
pvisauintuneautrefois.qͥlestoitensaceaille.etsicomilseoitseurunsiegedefustqilauoitfetfere,siuit.ii.deablesesterdesuslarocheqidesussabeieestoit.etsidisoientahauteuoizcrioientheteiate,brictio,heteiate,brictioetiecroi,fetgallus,qilueoitlarageladeruerieqilauoientelchetifmisecarilnedemoramiemoutapres:qebricesuintauseinthometozderuezsilecoumencaaledengierenplusdemilmanieres.apeinesseretenoitilqilnelicoroitseure.liseinzhomlapaisoitqanqilpooitpardocesparolesmeslideablesliestoitsientresdedenzlecors:qilnesepooittenirdelseinthomelaidengiereinzlidisoitqeparmaluestieauoitillessielacheualerieparfantosmeᷤparfausesauisionsdisoitilceqilfeisoitdisoit.etqantilotcezchosesditesautresqibienfontateire,ilsenralatoutcourantaussicomcilqiestoitsaoulezdegrantforsenerie.mesenlafin,sicomiecroi,fetgallus,furentchacielideabledesoncors.parlesorissonsdelseinthome.etdontrepairabricesaseintmartinsilicheiaspiezsiliproiamercipardondesesoeuresqilauoitfetesqillencharchastpenitancecarilsauoitbienqeceauoitesteoeurededeable.griefchosenestoitmieaseintmartinqillipardonastlemeffet.aceluiqimerciliqueroitainzlepardonoitmoutuolentierssanzdelaiance.lorspardonaabriceleshontesqilliauoitdites.dontcontaaluianosliseinzhomqilauoitueuzlesdeablesqicrioientensomlarocheqedeslaidengesqebricesliauoitditesnesestoitilmeuzensoncuernecorrociezporceqillisembloitqelesgreuoientplusceluiqilesdisoitqeluimeismes.neonqestantbricesnelisotdiredeshontesnedesfeloniesqilsencorroucast.neqilenuousistuenianceprendresicomilpeustfaireeinzdisoitmoutsouentensapenseeseiesucrizsosfriqeiudaslidistmeinteschoses.ieporqoibrisconnesosferroie	puisavintuneautrefois.qilestoitensaceaille.etsicomilseoitseurunsiegedefustqilavoitfetfere,sivit.ii.deablesesterdesuslarocheqidesussabeïeestoit.etsidisoientahautevoizetcrioientheteiate,brictio,heteiate,brictioetjecroi,fetgallus,qilveoitlarageetladerverieqilavoientelchetifmisecarilnedemoramiemoutaprés:qebricesvintauseinthometozdervezsilecoumençaaledengierenplusdemilmanieres.etapeinesseretenoitilqilnelicoroitseure.etliseinzhomlapaisoitqanqilpooitpardocesparolesmeslideablesliestoitsientrésdedenzlecors:qilnesepooittenirdelseinthomelaidengiereinzlidisoitqeparmalvestiéavoitillessiélachevalerieetparfantosmesetparfausesavisionsdisoitilceqilfeisoitetdisoit.etqantilotcezchosesditesetautresqibienfontateire,ilsenralatoutcourantaussicomcilqiestoitsaoulezdegrantforsenerie.mesenlafin,sicomjecroi,fetgallus,furentchaciélideabledesoncors.parlesorissonsdelseinthome.etdontrepairabricesaseintmartinsilicheïaspiezetsiliproiamercietpardondesesoevresqilavoitfetesetqillencharchastpenitancecarilsavoitbienqeceavoitestéoevrededeable.griefchosenestoitmieaseintmartinqillipardonastlemeffet.aceluiqimerciliqueroitainzlepardonoitmoutvolentierssanzdelaiance.lorspardonaabriceleshontesqilliavoitdites.dontcontaaluietanosliseinzhomqilavoitveüzlesdeablesqicrioientensomlarocheqedeslaidengesqebricesliavoitditesnesestoitilmeüzensoncuernecorrociezporceqillisembloitqelesgrevoientplusceluiqilesdisoitqeluimeïsmes.neonqestantbricesnelisotdiredeshontesnedesfeloniesqilsencorrouçast.neqilenvousistvenjanceprendresicomilpeüstfaireeinzdisoitmoutsoventensapenseesejesucrizsosfriqejudaslidistmeinteschoses.etjeporqoibrisconnesosferroie
dont	dont
respondi	respondi
postumiens	postumiens
si	etsi
dist	dist
moutfucilmaushomqiparreisonpartensneseuoutapeisierauseinthome.etmoutsedoitlendoloirdelachetiuecondition.delagrantpestilenceqienbriconestoitdontillaidengoitleseinthome.mesoreleissonsceesterdontlaparolenestmieboneameītenirsinosconteauantgalledeseintmartinlesoeures.	moutfucilmaushomqiparreisonetpartensnesevoutapeisierauseinthome.etmoutsedoitlendoloirdelachetivecondition.etdelagrantpestilenceqienbriçonestoitdontillaidengoitleseinthome.mesoreleissonsceesterdontlaparolenestmieboneameintenirsinosconteavantgalledeseintmartinlesoevres.
gaullus	gaullus
respondi	respondi
a	a
postumien	postumien
sidist	etsidist
postumien,uespresaprochelisolauzresconse.tensestatozceusqicisont.qimoutuolentiersontoieslesparoleslesoeuresdaleralaceine.sinenuoudroieplꝰconternediremessacesbienqetunedoizmieentendreaparueniralafindesesoeuresnedesesmiracles,carilnenianule:sinestnuzhomnezdemereqiparparoleslespeustconternediremesceqetuenasoiporterastuenorient.siespartlagloiredelui.lenonparlesdiuersesregionsespueplesoutuirasespartiesestranges.esleusesporsdemeresboursesdiuersescitez.siteramembrebiensouiegne.qetunetrespassesmiecompaignie.qetunelesidiesracontes.etsetescuerstauoieestdautreꝑt,nelessesmieqetuneuoisesapaulinqihauzhomestqimoutfetaloeraluiteproiieqeturaconteslesoeuresqenosauonshuihierdites.aceluidirastutoutraconterastutoutcarparceluiserontmeintenantaromeconeueslesoeuresdelseinthomecarparluifuseuznostrepremerainzliurespartoutelombardiepartotepuille.partotesezilepartotelaterredegrece.cilnamieenuiedesgranzuertuznedesgranzmiraclesdelseinthomeeinzlesaimemolt.etsetutedeparzdelaettutenuasenaufriquesileraconteencartageencoreconoissentil,siꝯmetunosasditlesoeuresdelseinthomesienconoisterontilplusoresineloerontmietantsolementseintcẏprienlormartir.etseilauenoitparauentureqeuenztetresportassentasenestreenachaiesilesiracontassesenchorinteenatheines.etencorefustgrecebeneureusedeceqeelefuconuertieparlapostreqilapreeschaiesucrist,nedeguerpimiefranceqilidonaseintmartinporliconuertiracreance.etqanttureuendrasenlat̉rredegẏpteencoreiaitiltantdeseinzhomesdontellesenorguellist﻿ꝑloruertuzparlormiraclesraconteileschosesqetuasueues,siconlessacheenaiseentouteeurope.etsetuparuienzenlaterredeierusalem,ietenioingproi:qe,setuariuesauportdecholomaideqetuuoisesalasepouturepomponienostrecompaignonqilafuenseueliz,sicomlenmaditcontesifaiasostantdoneurcomtupuezsiespantdeseurebelesfleursherbessoefflairanzencoresoientceueinesdones.etsilidirasmoutdocementnonmieparaspresparolesqesilteuousistcroiretieuziorzfuia,oumoiaussint,ouensiuiseintmartinmielzqeceluiqiieneuoelnomernedireilnefustmiedemoipartiznemorzenmernegetezesondessiqapeinesuintilaterreouileustsepouturenefustilmieenfouizenestrangeregion.orpuētueoirsoeurecilqimecuidierentnuireparledepartementdelui.ornesesioissentmesnenedemeinentleesce.	postumien,vespresaprocheetlisolauzresconse.ettensestatozceusqicisont.qimoutvolentiersontoïeslesparolesetlesoevresdaleralaceine.sinenvoudroieplusconternediremessacesbienqetunedoizmieentendreaparveniralafindesesoevresnedesesmiracles,carilnenianule:etsinestnuzhomnezdemereqiparparoleslespeüstconternediremesceqetuenasoïporterastuenorient.etsiespartlagloiredelui.etlenonparlesdiversesregionsespueplesoutuirasetespartiesestranges.etesleusetesporsdemeretesboursetesdiversescitez.etsiteramembrebienetsoviegne.qetunetrespassesmiecompaignie.qetunelesidiesetracontes.etsetescuersettavoieestdautrepart,nelessesmieqetunevoisesapaulinqihauzhomestetqimoutfetaloeretaluiteproijeqeturaconteslesoevresqenosavonshuiethierdites.aceluidirastutoutetraconterastutoutcarparceluiserontmeintenantaromeconeüeslesoevresdelseinthomecarparluifuseüznostrepremerainzlivrespartoutelombardieetpartotepuille.etpartotesezileetpartotelaterredegrece.cilnamieenviedesgranzvertuznedesgranzmiraclesdelseinthomeeinzlesaimemolt.etsetutedeparzdelaettutenvasenaufriquesileraconteencartageetencoreconoissentil,siconmetunosasditlesoevresdelseinthomesienconoisterontilplusoresineloerontmietantsolementseintcyprienlormartir.etseilavenoitparaventureqevenztetresportassentasenestreenachaïesilesiracontassesetenchorinteetenatheines.etencorefustgrecebeneüreusedeceqeelefuconvertieparlapostreqilapreeschajesucrist,nedeguerpimiefranceqilidonaseintmartinporliconvertiracreance.etqantturevendrasenlaterredegypteencoreiaitiltantdeseinzhomesdontellesenorguellist﻿parlorvertuzetparlormiraclesraconteileschosesqetuasveües,siconlessacheenaiseetentouteeurope.etsetuparvienzenlaterredejerusalem,jetenjoingetproi:qe,setuarivesauportdecholomaideqetuvoisesalasepouturepomponienostrecompaignonqilafuenseveliz,sicomlenmaditetcontéetsifaiasostantdoneurcomtupuezsiespantdeseurebelesfleursetherbessoefflairanzencoresoientceveinesdonés.etsilidirasmoutdocementnonmieparaspresparolesqesiltevousistcroiretieuzjorzfuja,oumoiaussint,ouensiviseintmartinmielzqeceluiqijenevoelnomernedireilnefustmiedemoipartiznemorzenmernegetezesondessiqapeinesvintilaterreouileüstsepouturenefustilmieenfouizenestrangeregion.orpuentveoirsoevrecilqimecuidierentnuireparledepartementdelui.ornesesjoïssentmesnenedemeinentleesce.
dont	dont
se	se
teut	teut
gallus	gallus
qant	qant
ilot	ilot
a	a
postumien	postumien
cez	cez
choses	choses
diteset	diteset
si	si
comil	comil
ploroient	ploroient
tuit	tuit
por	por
pomponie	pomponie
lor	lor
chier	chier
compaignon	compaignon
dont	dont
il	il
auoient	avoient
tuit	tuit
la	la
﻿ꝑole	﻿parole
ramenteueil	ramenteüeil
se	se
leuerent	leverent
tuit	tuit
deꝑtirent	etdepartirent
car	car
iaestoit	jaestoit
pres	pres
de	de
la	la
uespree	vespree
or	or
uos	vos
ai	ai
lueure	luevre
consommee	consommee
des	des
miracles	miracles
de	de
seint	seint
martin	martin
sicom	sicom
ies	jes
trouai	trovai
ellatin	ellatin
qe	qe
seuerus	severus
fist	fist
treitames	ettreitames
gauchiers	gauchiers
qiles	qiles
translataen	translataen
romanz	romanz
auant	avant
nos	nos
raconte	raconte
de	de
namur	namur
son	son
signor	signor
auant	avant
la	la
uie	vie
de	de
seint	seint
brice	brice
sanz	sanz
seior	sejor
qi	qi
fu	fu
esleuz	esleüz
aarcheuesque	aarchevesque
delpais	delpaïs
apres	aprés
la	la
mort	mort
de	de
ceseint	ceseint
home	home
dont	dont
contee	contee
uous	vous
aila	aila
some	some
or	or
aiez	aiez
pais	pais
siaiez	etsiaiez
	et
uos	vos
cuers	cuers
bien	bien
apoiez	apoiez
car	car
pou	pou
puet	puet
libiens	libiens
profiter	profiter
celui	celui
qi	qi
nel	nel
uiut	viut
escouter	escouter
aenuiz	aenviz
fet	fet
bien	bien
ce	ce
mest	mest
vis	vis
qile	qile
bien	bien
escoute	escoute
aenuiz	aenviz
oraiezpaissiaiez.uoscuersbienapoiezcarpoupuetlibiensprofiter.celuiqineluiutescouter.aenuizfetbien,cemestvisqilebienescouteaenuiz.	oraiezpaisetsiaiez.etvoscuersbienapoiezcarpoupuetlibiensprofiter.celuiqinelviutescouter.aenvizfetbien,cemestvisqilebienescouteaenviz.
